,Year,District,2 Year,4 Year,Not Enrolled,all_students,female,male,gender_x,american_indian_alaskan_native,asian,black_african_american,hispanic_latino_of_any_race,native_hawaiian_other_pacific,two_or_more_races,white,english_language_learners,highly_capable,low_income,non_english_language_learners,non_highly_capable,non_low_income
0,2014,Aberdeen,0.43999999999999995,0.18,0.385,3404,1661,1743,0,145,86,46,1003,10,162,1952,334,96,2472,3070,3308,932
1,2014,Adna,0.42,0.12,0.47,610,287,323,0,3,4,3,35,0,14,551,0,0,176,610,610,434
2,2014,Anacortes,0.275,0.42000000000000004,0.31,2708,1338,1370,0,20,92,42,226,8,44,2274,61,46,898,2647,2662,1810
3,2014,Arlington,0.31,0.275,0.41500000000000004,5575,2661,2914,0,63,84,62,667,30,279,4390,217,3,2089,5358,5572,3486
4,2014,Auburn,0.28500000000000003,0.325,0.3875,15685,7730,7955,0,221,1198,1063,4148,530,1444,7081,2341,227,9349,13344,15458,6336
5,2014,Bainbridge Island,0.09,0.745,0.165,3914,1908,2006,0,23,131,27,255,4,319,3155,28,0,350,3886,3914,3564
6,2014,Battle Ground,0.362,0.21800000000000003,0.41600000000000004,13530,6598,6932,0,34,258,85,1128,44,692,11289,756,211,5660,12774,13319,7870
7,2014,Bellevue,0.22000000000000003,0.618,0.16,19464,9312,10152,0,28,6677,536,2294,39,1735,8155,1525,1711,4099,17939,17753,15365
8,2014,Bellingham,0.2975,0.435,0.2675,11098,5343,5755,0,116,621,156,1686,37,802,7680,689,1,4454,10409,11097,6644
9,2014,Bethel,0.246,0.196,0.5599999999999999,18468,8755,9713,0,266,896,1515,2813,550,1662,10766,353,790,10253,18115,17678,8215
10,2014,Blaine,0.25,0.3,0.45,2222,1078,1144,0,17,61,29,275,31,131,1678,86,78,1077,2136,2144,1145
11,2014,Bremerton,0.32999999999999996,0.22999999999999998,0.44,5121,2414,2707,0,61,196,287,935,119,839,2684,213,66,3502,4908,5055,1619
12,2014,Brewster,0.3,0.2,0.5,1017,465,552,0,8,0,1,925,0,5,77,483,0,977,534,1017,40
13,2014,Burlington-Edison,0.415,0.255,0.33,3776,1833,1943,0,39,67,24,1493,7,108,2037,750,220,2072,3026,3556,1704
14,2014,Camas,0.265,0.44999999999999996,0.28,6674,3239,3435,0,22,405,55,517,29,502,5144,136,0,1276,6538,6674,5398
15,2014,Cape Flattery,0.36,0.15,0.48,458,230,228,0,208,0,0,87,0,84,79,0,4,333,458,454,125
16,2014,Cascade,0.34,0.32,0.33,1249,616,633,0,12,9,4,372,1,17,834,160,0,640,1089,1249,609
17,2014,Castle Rock,0.23,0.2,0.57,1301,621,680,0,15,9,4,129,11,77,1056,25,22,679,1276,1279,622
18,2014,Central Kitsap,0.3675,0.275,0.355,11039,5320,5719,0,53,599,348,1306,123,1791,6819,278,178,4277,10761,10861,6762
19,2014,Central Valley,0.25666666666666665,0.3566666666666667,0.3833333333333333,13383,6412,6971,0,104,188,220,898,72,582,11319,345,1495,6017,13038,11888,7366
20,2014,Centralia,0.32,0.13,0.55,3660,1786,1874,0,22,28,36,1176,11,128,2259,339,61,2786,3321,3599,874
21,2014,Chehalis,0.37,0.28,0.34,3001,1383,1618,0,22,39,53,516,2,184,2185,111,0,1571,2890,3001,1430
22,2014,Cheney,0.3,0.27,0.425,4523,2138,2385,0,71,83,76,433,23,326,3511,142,247,2410,4381,4276,2113
23,2014,Chewelah,0.31666666666666665,0.25666666666666665,0.42,865,401,464,0,6,3,8,32,2,19,795,4,25,558,861,840,307
24,2014,Chimacum,0.23,0.28,0.49,1091,526,565,0,17,20,9,72,2,68,903,10,41,607,1081,1050,484
25,2014,Clarkston,0.22999999999999998,0.32,0.445,2668,1327,1341,0,52,22,31,190,0,105,2268,35,18,1635,2633,2650,1033
26,2014,Cle Elum-Roslyn,0.07,0.39,0.5349999999999999,927,452,475,0,12,9,6,86,2,39,773,19,22,424,908,905,503
27,2014,Clover Park,0.2733333333333334,0.29666666666666663,0.43,13038,6255,6783,0,74,572,1610,4086,539,1640,4517,1458,53,9456,11580,12985,3582
28,2014,Colfax,0.29,0.4,0.31,597,281,316,0,0,4,3,21,0,44,525,0,0,210,597,597,387
29,2014,Columbia (Walla Walla),0.41,0.24,0.34,861,422,439,0,4,2,7,264,0,29,555,108,37,458,753,824,403
30,2014,Colville,0.24,0.33499999999999996,0.425,1807,913,894,0,36,12,8,83,4,73,1591,33,0,1044,1774,1807,763
31,2014,Coupeville,0.16,0.41,0.43,920,488,432,0,1,10,16,111,1,95,686,23,0,367,897,920,553
32,2014,Darrington,0.39,0.19,0.42,440,212,228,0,21,3,3,28,0,31,354,0,1,276,440,439,164
33,2014,Davenport,0.13,0.46,0.41,597,316,281,0,12,4,1,15,0,5,560,0,0,357,597,597,240
34,2014,Dayton,0.52,0.14,0.34,465,237,228,0,14,5,7,65,0,10,364,0,1,291,465,464,174
35,2014,Deer Park,0.17,0.18,0.64,2472,1216,1256,0,52,13,35,104,3,10,2255,4,0,1310,2468,2472,1162
36,2014,East Valley (Spokane),0.32,0.2,0.48,4297,2104,2193,0,54,56,47,402,27,319,3392,132,205,2444,4165,4092,1853
37,2014,East Valley (Yakima),0.33,0.3,0.37,3089,1475,1614,0,35,27,29,1385,4,62,1547,394,0,1906,2695,3089,1183
38,2014,Eastmont,0.39,0.19,0.42,5885,2821,3064,0,19,39,18,2587,7,149,3066,1143,0,3357,4742,5885,2528
39,2014,Eatonville,0.24,0.26,0.5,1895,962,933,0,22,12,13,128,6,114,1600,10,0,832,1885,1895,1063
40,2014,Edmonds,0.33799999999999997,0.41200000000000003,0.25,20884,9989,10895,0,109,2613,1292,3917,139,2050,10764,2480,590,8803,18404,20294,12081
41,2014,Ellensburg,0.165,0.46499999999999997,0.37,3143,1573,1570,0,35,46,33,551,7,30,2441,256,164,1361,2887,2979,1782
42,2014,Elma,0.385,0.175,0.435,1507,745,762,0,22,13,9,245,0,115,1102,105,10,865,1402,1497,642
43,2014,Enumclaw,0.24,0.34,0.42,4106,1965,2141,0,61,23,34,583,11,160,3234,216,74,1418,3890,4032,2688
44,2014,Ephrata,0.36,0.235,0.405,2418,1168,1250,0,5,16,12,707,0,48,1629,250,25,1427,2168,2393,991
45,2014,Everett,0.335,0.3375,0.3275,19764,9735,10029,0,133,2451,795,3441,271,1285,11388,2341,973,8739,17423,18791,11025
46,2014,Evergreen (Clark),0.31,0.25,0.435,26446,12781,13665,0,145,1741,789,4907,442,2023,16399,3118,1277,13723,23328,25169,12723
47,2014,Federal Way,0.262,0.33799999999999997,0.40199999999999997,22919,11181,11738,0,144,2686,2744,6208,1057,2760,7320,3661,1111,14605,19258,21808,8314
48,2014,Ferndale,0.365,0.255,0.38,4958,2414,2544,0,427,170,51,890,8,284,3128,280,1114,2596,4678,3844,2362
49,2014,Fife,0.37,0.26,0.37,3637,1774,1863,0,35,265,136,709,128,461,1903,418,0,1740,3219,3637,1897
50,2014,Finley,0.29,0.18,0.53,913,417,496,0,5,2,3,376,0,37,490,133,0,714,780,913,199
51,2014,Franklin Pierce,0.2833333333333334,0.25333333333333335,0.4666666666666666,7820,3787,4033,0,73,529,835,1985,421,1026,2951,675,1218,6269,7145,6602,1551
52,2014,Goldendale,0.28,0.29,0.43,934,425,509,0,45,11,5,119,2,48,704,29,21,567,905,913,367
53,2014,Grand Coulee Dam,0.22,0.22,0.56,785,388,397,0,306,4,3,87,2,156,227,0,0,545,785,785,240
54,2014,Grandview,0.29500000000000004,0.175,0.53,3727,1856,1871,0,1,2,3,3433,0,16,272,1262,0,3148,2465,3727,579
55,2014,Granger,0.18,0.28,0.54,1593,740,853,0,44,0,1,1484,0,19,45,633,0,1343,960,1593,250
56,2014,Granite Falls,0.215,0.185,0.6000000000000001,2043,970,1073,0,39,21,19,185,6,86,1685,33,0,953,2010,2043,1090
57,2014,Highland,0.28,0.32,0.39,1214,570,644,0,8,4,6,874,0,28,294,309,66,968,905,1148,246
58,2014,Highline,0.35,0.28625,0.365,19630,9362,10268,0,181,2804,2515,7389,829,1312,4599,5018,528,14256,14612,19102,5374
59,2014,Hockinson,0.22,0.46,0.32,1929,918,1011,0,6,37,14,86,0,52,1734,23,148,442,1906,1781,1487
60,2014,Hoquiam,0.48,0.15000000000000002,0.37,1680,832,848,0,92,14,26,315,2,70,1160,49,38,1213,1631,1642,467
61,2014,Issaquah,0.2125,0.64,0.14750000000000002,19424,9541,9883,0,40,4751,341,1505,62,1227,11498,1026,664,2102,18398,18760,17322
62,2014,Kalama,0.27,0.16,0.57,941,450,491,0,6,10,9,45,4,21,846,5,20,398,936,921,543
63,2014,Kelso,0.335,0.185,0.485,4939,2446,2493,0,81,55,23,807,30,345,3598,262,0,2981,4677,4939,1958
64,2014,Kennewick,0.325,0.2525,0.4225,17568,8395,9173,0,92,380,429,5159,34,480,10994,2253,179,10525,15315,17389,7043
65,2014,Kent,0.384,0.356,0.26,28108,13399,14709,0,126,4874,3458,6008,671,2664,10306,5084,497,15806,23024,27611,12302
66,2014,Kettle Falls,0.245,0.26,0.49,928,465,463,0,24,8,4,54,3,24,811,0,18,515,928,910,413
67,2014,Kittitas,0.19,0.38,0.43,669,321,348,0,4,7,4,144,1,10,499,54,1,333,615,668,336
68,2014,La Center,0.34,0.26,0.4,1621,777,844,0,8,18,9,104,0,31,1451,35,0,500,1586,1621,1121
69,2014,La Conner,0.3,0.45,0.26,660,317,343,0,221,5,2,63,4,23,342,71,10,352,589,650,308
70,2014,Lake Chelan,0.32,0.425,0.265,1490,698,792,0,2,6,3,812,0,12,655,401,24,1015,1089,1466,475
71,2014,Lake Stevens,0.36,0.25,0.39,8512,4070,4442,0,53,295,147,1125,29,642,6221,313,306,2826,8199,8206,5686
72,2014,Lake Washington,0.23399999999999999,0.592,0.176,26923,12964,13959,0,67,5788,440,2879,41,1897,15811,2171,1474,3991,24752,25449,22932
73,2014,Lakewood,0.26,0.2,0.54,2398,1145,1253,0,35,43,38,341,12,144,1785,109,36,777,2289,2362,1621
74,2014,Liberty,0.25,0.38,0.38,420,186,234,0,3,0,2,25,0,11,379,0,6,170,420,414,250
75,2014,Longview,0.41333333333333333,0.22666666666666666,0.3633333333333333,6724,3320,3404,0,81,119,68,1317,22,476,4641,394,183,4340,6330,6541,2384
76,2014,Lynden,0.3,0.28,0.42,2963,1442,1521,0,9,72,37,680,3,86,2076,263,0,1103,2700,2963,1860
77,2014,Mabton,0.22,0.14,0.63,978,492,486,0,0,0,0,950,0,0,28,394,0,944,584,978,34
78,2014,Manson,0.51,0.17,0.31,709,334,375,0,6,6,6,482,0,2,207,239,0,570,470,709,139
79,2014,Marysville,0.33285714285714285,0.25285714285714284,0.41714285714285715,11544,5668,5876,0,701,576,182,2458,87,1151,6389,879,383,6157,10665,11161,5387
80,2014,Mead,0.255,0.495,0.25,9855,4802,5053,0,40,81,112,560,64,770,8228,240,555,3345,9615,9300,6510
81,2014,Medical Lake,0.28,0.275,0.43999999999999995,2009,915,1094,0,6,23,64,209,9,187,1511,10,15,778,1999,1994,1231
82,2014,Mercer Island,0.1,0.8,0.1,4444,2092,2352,0,8,845,61,193,9,300,3028,103,656,220,4341,3788,4224
83,2014,Meridian,0.36,0.25,0.39,1755,844,911,0,18,73,22,310,1,67,1264,117,17,715,1638,1738,1040
84,2014,Methow Valley,0.11,0.47,0.42000000000000004,647,310,337,0,2,10,0,39,0,17,579,7,0,340,640,647,307
85,2014,Monroe,0.26,0.33499999999999996,0.4,7299,3567,3732,0,63,182,88,1363,19,329,5255,558,1171,2223,6741,6128,5076
86,2014,Montesano,0.51,0.18,0.31,1329,646,683,0,18,16,1,136,0,82,1075,17,22,547,1312,1307,782
87,2014,Moses Lake,0.295,0.22999999999999998,0.475,8263,4058,4205,0,54,78,116,3669,4,208,4134,913,304,5471,7350,7959,2792
88,2014,Mount Adams,0.13,0.31,0.56,958,479,479,0,502,0,0,353,0,62,41,155,0,915,803,958,43
89,2014,Mount Vernon,0.36,0.31,0.33,6589,3230,3359,0,40,116,61,3611,36,150,2575,1639,4,4612,4950,6585,1977
90,2014,Mukilteo,0.32,0.37333333333333335,0.3033333333333333,15386,7326,8060,0,68,2303,895,4273,175,1320,6352,2788,465,8394,12598,14921,6992
91,2014,Napavine,0.34,0.17,0.49,792,388,404,0,7,4,5,98,0,27,651,25,0,409,767,792,383
92,2014,Newport,0.16,0.32999999999999996,0.51,1074,504,570,0,3,5,3,44,1,68,950,0,119,698,1074,955,376
93,2014,Nine Mile Falls,0.39,0.27,0.34,1495,734,761,0,32,5,15,61,4,86,1292,0,50,450,1495,1445,1045
94,2014,Nooksack Valley,0.4,0.21,0.38,1675,823,852,0,72,14,6,536,1,87,959,208,0,1017,1467,1675,658
95,2014,North Franklin,0.24,0.19,0.5700000000000001,2150,1013,1137,0,3,24,7,1520,2,20,574,749,0,1678,1401,2150,472
96,2014,North Kitsap,0.26666666666666666,0.37333333333333335,0.3566666666666667,6137,3041,3096,0,253,185,62,707,20,672,4238,199,284,2281,5938,5853,3856
97,2014,North Mason,0.295,0.175,0.53,2156,1064,1092,0,18,23,18,389,12,151,1545,188,29,1239,1968,2127,917
98,2014,Northshore,0.252,0.476,0.26999999999999996,21230,10292,10938,0,84,3071,383,2660,65,1687,13280,1328,648,3898,19902,20582,17332
99,2014,Oak Harbor,0.32,0.28,0.4,5684,2704,2980,0,30,477,284,785,53,521,3534,190,100,2497,5494,5584,3187
100,2014,Ocean Beach,0.27,0.2,0.52,1028,481,547,0,16,10,0,169,0,64,769,64,23,704,964,1005,324
101,2014,Ocosta,0.3,0.13,0.57,653,315,338,0,27,7,3,137,0,62,417,63,15,479,590,638,174
102,2014,Okanogan,0.42,0.22,0.36,1092,533,559,0,114,3,1,258,0,69,646,96,12,691,996,1080,401
103,2014,Olympia,0.26666666666666666,0.5066666666666667,0.22666666666666668,9777,4685,5092,0,42,731,184,1038,32,940,6810,219,24,3225,9558,9753,6552
104,2014,Omak,0.27,0.32499999999999996,0.405,5218,2684,2534,0,412,195,210,635,40,183,3543,149,21,2057,5069,5197,3161
105,2014,Onalaska,0.375,0.15000000000000002,0.475,762,361,401,0,8,4,1,83,0,25,641,27,0,459,735,762,303
106,2014,Orcas Island,0.20500000000000002,0.415,0.375,882,443,439,0,3,21,18,67,3,38,732,38,0,242,844,882,640
107,2014,Oroville,0.17,0.27,0.56,585,282,303,0,14,7,3,213,2,11,335,90,0,414,495,585,171
108,2014,Orting,0.22,0.18,0.6,2438,1209,1229,0,13,25,28,316,8,182,1866,50,23,1039,2388,2415,1399
109,2014,Othello,0.3,0.31,0.38,4134,1978,2156,0,0,8,4,3640,0,21,461,1623,73,3446,2511,4061,688
110,2014,Pasco,0.325,0.16999999999999998,0.5,17183,8329,8854,0,17,190,272,11988,31,389,4296,6147,584,12923,11036,16599,4260
111,2014,Peninsula,0.24333333333333332,0.4566666666666667,0.30333333333333334,9101,4430,4671,0,44,162,67,675,18,771,7364,69,160,2497,9032,8941,6604
112,2014,Port Angeles,0.42,0.215,0.37,3793,1830,1963,0,186,63,28,292,6,422,2796,47,65,2169,3746,3728,1624
113,2014,Port Townsend,0.26,0.4,0.34,1204,608,596,0,10,28,18,81,5,68,993,14,0,642,1190,1204,562
114,2014,Prosser,0.225,0.275,0.495,2828,1412,1416,0,6,33,12,1743,1,46,987,633,83,1929,2195,2745,899
115,2014,Pullman,0.16,0.56,0.28,2685,1281,1404,0,15,255,70,275,9,175,1886,151,55,843,2534,2630,1842
116,2014,Puyallup,0.2775,0.34,0.3875,21665,10428,11237,0,191,1016,774,3282,282,2525,13595,918,916,8495,20747,20749,13170
117,2014,Quillayute Valley,0.16999999999999998,0.2,0.63,2877,1574,1303,0,112,49,118,549,13,180,1856,116,54,1797,2761,2823,1080
118,2014,Quincy,0.475,0.11499999999999999,0.41000000000000003,2710,1363,1347,0,0,2,3,2354,0,7,344,1148,47,2340,1562,2663,370
119,2014,Rainier,0.49,0.18,0.33,838,412,426,0,12,7,5,74,1,43,696,5,0,481,833,838,357
120,2014,Raymond,0.33,0.28,0.39,697,333,364,0,17,37,6,151,3,24,459,64,1,435,633,696,262
121,2014,Reardan-Edwall,0.27,0.29,0.44,607,295,312,0,32,1,3,24,0,37,510,29,0,287,578,607,320
122,2014,Renton,0.335,0.305,0.36,15776,7608,8168,0,99,3883,2775,3457,148,1112,4302,2521,475,9038,13255,15301,6738
123,2014,Richland,0.25,0.41,0.34,12718,6218,6500,0,71,474,257,1993,28,447,9448,471,270,4845,12247,12448,7873
124,2014,Ridgefield,0.33,0.32,0.36,2339,1174,1165,0,6,34,16,246,3,111,1923,77,109,785,2262,2230,1554
125,2014,Ritzville,0.39,0.43,0.17,383,176,207,0,6,5,6,28,1,2,335,0,0,162,383,383,221
126,2014,Riverside,0.255,0.21000000000000002,0.535,1520,709,811,0,45,7,8,65,4,22,1369,11,15,786,1509,1505,734
127,2014,Riverview,0.245,0.41500000000000004,0.33999999999999997,3306,1690,1616,0,18,84,17,413,9,151,2614,109,30,658,3197,3276,2648
128,2014,Rochester,0.355,0.08,0.5700000000000001,2242,1063,1179,0,78,7,14,458,1,145,1539,106,107,1279,2136,2135,963
129,2014,Royal,0.31,0.28,0.41,1679,839,840,0,0,2,1,1376,0,2,298,771,0,1176,908,1679,503
130,2014,San Juan Island,0.22,0.53,0.25,793,395,398,0,4,12,5,129,1,37,605,36,90,396,757,703,397
131,2014,Sedro-Woolley,0.37,0.22,0.42,4394,2161,2233,0,97,37,39,874,12,150,3185,204,14,2511,4190,4380,1883
132,2014,Selah,0.325,0.29000000000000004,0.385,3615,1751,1864,0,25,12,18,1001,2,89,2468,214,59,1914,3401,3556,1701
133,2014,Sequim,0.37,0.29,0.34,2910,1439,1471,0,55,43,15,296,4,221,2276,44,63,1447,2866,2847,1463
134,2014,Shelton,0.29500000000000004,0.17,0.535,4265,2046,2219,0,143,21,17,1180,16,293,2595,451,110,3002,3814,4155,1263
135,2014,Shoreline,0.26333333333333336,0.55,0.18666666666666668,9339,4474,4865,0,40,1286,652,1187,40,1048,5086,681,628,2892,8658,8711,6447
136,2014,Snohomish,0.3333333333333333,0.39666666666666667,0.27,10150,4928,5222,0,68,386,115,991,20,561,8009,317,1222,2523,9833,8928,7627
137,2014,Snoqualmie Valley,0.275,0.5,0.22499999999999998,6688,3187,3501,0,35,325,56,434,12,274,5552,145,158,998,6543,6530,5690
138,2014,South Bend,0.31,0.26,0.44,633,297,336,0,19,20,1,269,4,73,247,98,0,373,535,633,260
139,2014,South Kitsap,0.33499999999999996,0.21500000000000002,0.44499999999999995,9514,4538,4976,0,91,280,141,1019,145,1064,6774,123,271,4282,9391,9243,5232
140,2014,South Whidbey,0.17,0.48,0.35,1467,718,749,0,13,44,16,88,5,47,1254,10,3,500,1457,1464,967
141,2014,Spokane,0.26833333333333337,0.365,0.36333333333333334,30278,14695,15583,0,468,747,841,3011,444,3812,20955,1521,819,18651,28757,29459,11627
142,2014,Stanwood-Camano,0.31,0.275,0.42500000000000004,4528,2180,2348,0,37,71,43,393,8,200,3775,92,107,1395,4436,4421,3133
143,2014,Stevenson-Carson,0.18,0.33,0.49,970,448,522,0,20,5,16,143,3,43,740,20,34,548,950,936,422
144,2014,Sumner,0.28,0.34,0.3833333333333333,8987,4421,4566,0,81,181,86,1153,41,714,6731,317,286,3394,8670,8701,5593
145,2014,Sunnyside,0.21,0.25,0.54,6685,3192,3493,0,3,2,8,6148,0,52,472,1594,38,5536,5091,6647,1149
146,2014,Tacoma,0.25375000000000003,0.34125,0.40249999999999997,30613,15055,15558,0,371,3028,5767,5752,795,2085,12815,2572,1522,20671,28041,29091,9942
147,2014,Tahoma,0.33,0.39,0.29,8093,3927,4166,0,39,312,129,759,45,669,6140,146,64,1392,7947,8029,6701
148,2014,Tenino,0.25,0.18,0.57,1237,561,676,0,10,6,14,88,4,39,1076,11,33,640,1226,1204,597
149,2014,Toledo,0.28500000000000003,0.16,0.5549999999999999,733,361,372,0,12,6,6,71,1,41,596,14,11,406,719,722,327
150,2014,Tonasket,0.22,0.25,0.53,1107,517,590,0,6,3,5,429,0,36,628,193,0,763,914,1107,344
151,2014,Toppenish,0.22,0.29000000000000004,0.485,4468,2194,2274,0,525,24,15,3427,1,45,431,1418,160,4181,3050,4308,287
152,2014,Tukwila,0.43,0.25,0.32,3164,1557,1607,0,24,841,693,869,108,211,418,1203,123,2614,1961,3041,550
153,2014,Tumwater,0.28,0.33666666666666667,0.38000000000000006,6236,3036,3200,0,46,167,115,631,31,570,4676,87,171,2172,6149,6065,4064
154,2014,University Place,0.31,0.45,0.23,5656,2777,2879,0,31,511,529,720,55,907,2903,236,114,2440,5420,5542,3216
155,2014,Vancouver,0.2783333333333333,0.34,0.3833333333333333,23451,11461,11990,0,134,788,652,5487,447,1588,14355,2914,255,13251,20537,23196,10200
156,2014,Vashon Island,0.27,0.5549999999999999,0.175,1588,747,841,0,9,48,13,173,0,128,1217,39,0,411,1549,1588,1177
157,2014,Wahluke,0.31,0.14500000000000002,0.545,2425,1204,1221,0,14,0,0,2318,0,5,88,1437,0,2347,988,2425,78
158,2014,Wapato,0.265,0.255,0.485,3290,1600,1690,0,681,47,1,2358,4,95,104,991,57,3245,2299,3233,45
159,2014,Warden,0.39,0.15,0.46,992,510,482,0,0,4,2,794,0,13,179,328,0,803,664,992,189
160,2014,Washougal,0.305,0.235,0.45999999999999996,3159,1524,1635,0,21,42,22,311,3,202,2558,69,0,1401,3090,3159,1758
161,2014,Wenatchee,0.38,0.29000000000000004,0.32999999999999996,7941,3826,4115,0,29,67,37,3874,7,194,3733,1835,609,5009,6106,7332,2932
162,2014,West Valley (Spokane),0.34,0.24,0.42,3925,1893,2032,0,39,53,65,293,10,269,3196,102,31,2291,3823,3894,1634
163,2014,West Valley (Yakima),0.27,0.39,0.34,5014,2428,2586,0,47,127,45,1349,6,144,3296,422,291,2200,4592,4723,2814
164,2014,White River,0.26,0.26,0.49,3661,1729,1932,0,37,29,22,330,9,206,3028,83,78,1344,3578,3583,2317
165,2014,White Salmon Valley,0.21,0.36,0.43,1317,622,695,0,9,9,5,429,1,31,833,194,0,685,1123,1317,632
166,2014,Winlock,0.4,0.2,0.405,710,312,398,0,4,4,4,178,0,34,486,75,0,638,635,710,72
167,2014,Woodland,0.245,0.2,0.55,2266,1065,1201,0,15,9,19,424,1,64,1734,155,247,1170,2111,2019,1096
168,2014,Yakima,0.3233333333333333,0.24666666666666667,0.43,16179,8029,8150,0,143,85,143,12380,9,416,3003,5516,528,14371,10663,15651,1808
169,2014,Yelm,0.255,0.265,0.48,5632,2691,2941,0,73,83,84,747,36,533,4076,101,0,2751,5531,5632,2881
170,2014,Zillah,0.32,0.38,0.3,1336,609,727,0,54,6,3,655,1,37,580,149,0,765,1187,1336,571
171,2015,Aberdeen,0.37,0.19,0.435,3394,1684,1710,0,128,78,39,1063,10,193,1883,385,89,2419,3009,3305,975
172,2015,Adna,0.41,0.17,0.41,629,289,340,0,4,5,2,41,0,15,562,3,0,193,626,629,436
173,2015,Anacortes,0.25,0.44,0.31,2809,1367,1442,0,22,96,34,288,5,65,2299,51,72,905,2758,2737,1904
174,2015,Arlington,0.3,0.29000000000000004,0.405,5612,2689,2923,0,63,88,57,727,25,315,4337,244,0,2123,5368,5612,3489
175,2015,Auburn,0.315,0.3025,0.3825,16126,7886,8240,0,212,1267,1110,4484,546,1546,6961,2546,266,9450,13580,15860,6676
176,2015,Bainbridge Island,0.11499999999999999,0.7050000000000001,0.18,3942,1905,2037,0,21,135,22,275,4,341,3144,31,0,333,3911,3942,3609
177,2015,Battle Ground,0.312,0.24,0.45,13501,6547,6954,0,30,275,80,1129,49,637,11296,517,225,5271,12984,13276,8230
178,2015,Bellevue,0.19333333333333336,0.64,0.16666666666666666,20200,9646,10554,0,25,7271,541,2400,47,1823,8093,2400,1905,4053,17800,18295,16147
179,2015,Bellingham,0.3025,0.4425,0.2575,11273,5441,5832,0,127,633,168,1790,41,844,7670,739,2,4546,10534,11271,6727
180,2015,Bethel,0.23600000000000004,0.202,0.5599999999999999,18991,9078,9913,0,240,839,1508,3007,628,1931,10838,650,975,9694,18341,18016,9297
181,2015,Blaine,0.28,0.23,0.49,2238,1068,1170,0,19,71,36,281,19,121,1691,92,64,1121,2146,2174,1117
182,2015,Bremerton,0.29000000000000004,0.24,0.46499999999999997,5204,2431,2773,0,57,187,311,964,103,823,2759,234,62,3467,4970,5142,1737
183,2015,Brewster,0.255,0.255,0.49,1000,454,546,0,7,2,1,902,0,5,83,459,0,904,541,1000,96
184,2015,Burlington-Edison,0.345,0.23,0.42,3608,1745,1863,0,30,59,32,1461,9,111,1905,747,210,1970,2861,3398,1638
185,2015,Camas,0.235,0.495,0.27,7012,3437,3575,0,23,448,53,565,31,533,5359,166,116,1250,6846,6896,5762
186,2015,Cape Flattery,0.37,0.15,0.49,475,242,233,0,227,0,0,92,0,88,68,0,5,360,475,470,115
187,2015,Cascade,0.27,0.31,0.42,1372,667,705,0,10,9,4,396,2,20,928,187,0,681,1185,1372,691
188,2015,Castle Rock,0.29,0.2,0.51,1248,587,661,0,12,5,4,112,7,72,1036,24,17,663,1224,1231,585
189,2015,Central Kitsap,0.34750000000000003,0.3025,0.345,10959,5294,5665,0,49,573,347,1390,150,1798,6652,298,153,4045,10661,10806,6914
190,2015,Central Valley,0.26666666666666666,0.30666666666666664,0.4266666666666667,13711,6559,7152,0,124,208,248,1008,98,580,11445,434,1911,5511,13277,11800,8200
191,2015,Centralia,0.33999999999999997,0.11499999999999999,0.55,3555,1711,1844,0,22,24,38,1155,8,136,2171,374,85,2770,3181,3470,785
192,2015,Chehalis,0.34,0.28500000000000003,0.375,3033,1410,1623,0,19,35,35,551,5,170,2218,133,0,1555,2900,3033,1478
193,2015,Cheney,0.22,0.395,0.385,4637,2175,2462,0,81,76,84,473,28,314,3581,129,263,2367,4508,4374,2270
194,2015,Chewelah,0.2833333333333334,0.29333333333333333,0.42333333333333334,800,373,427,0,5,5,7,31,2,28,722,0,35,509,800,765,291
195,2015,Chimacum,0.24,0.26,0.5,1102,545,557,0,13,18,9,94,2,75,891,12,22,594,1090,1080,508
196,2015,Clarkston,0.16499999999999998,0.32,0.515,2677,1339,1338,0,46,25,32,188,1,105,2280,34,18,1622,2643,2659,1055
197,2015,Cle Elum-Roslyn,0.185,0.49,0.32,903,440,463,0,5,7,6,93,1,41,750,20,26,412,883,877,491
198,2015,Clover Park,0.2866666666666667,0.27,0.4466666666666667,13214,6337,6877,0,67,584,1636,4237,561,1733,4391,1418,62,9903,11796,13152,3311
199,2015,Colfax,0.14,0.55,0.31,600,274,326,0,3,4,1,20,0,45,527,0,0,191,600,600,409
200,2015,Columbia (Walla Walla),0.4,0.23,0.37,855,427,428,0,6,5,7,278,0,17,542,116,31,450,739,824,405
201,2015,Colville,0.245,0.195,0.56,1823,910,913,0,32,10,10,91,1,77,1602,28,0,1021,1795,1823,802
202,2015,Coupeville,0.37,0.35,0.28,962,504,458,0,0,13,15,129,0,104,700,25,0,342,937,962,620
203,2015,Darrington,0.33,0.22,0.44,446,221,225,0,18,3,2,34,0,31,358,6,1,290,440,445,156
204,2015,Davenport,0.15,0.21,0.64,607,322,285,0,13,3,1,16,0,7,567,0,2,369,607,605,238
205,2015,Dayton,0.23,0.36,0.41,414,218,196,0,14,4,3,65,0,8,320,2,0,258,412,414,156
206,2015,Deer Park,0.23,0.2,0.56,2532,1236,1296,0,61,14,37,125,6,16,2273,11,249,1360,2521,2283,1172
207,2015,East Valley (Spokane),0.31,0.22,0.47,4354,2141,2213,0,47,56,49,436,42,313,3411,125,182,2516,4229,4172,1838
208,2015,East Valley (Yakima),0.28,0.26,0.46,3131,1497,1634,0,27,24,29,1467,4,66,1514,430,1,1920,2701,3130,1211
209,2015,Eastmont,0.36,0.23,0.42,6021,2913,3108,0,16,40,19,2752,5,170,3019,1106,0,3343,4915,6021,2678
210,2015,Eatonville,0.29,0.28,0.43,1920,949,971,0,15,10,11,127,10,116,1631,10,29,826,1910,1891,1094
211,2015,Edmonds,0.35,0.376,0.272,21049,10128,10921,0,103,2654,1297,4110,152,2180,10552,2573,814,8671,18476,20235,12378
212,2015,Ellensburg,0.13,0.42,0.445,3244,1598,1646,0,26,56,41,552,9,52,2508,245,193,1338,2999,3051,1906
213,2015,Elma,0.305,0.15500000000000003,0.535,1436,699,737,0,17,9,6,266,0,121,994,117,7,921,1319,1429,515
214,2015,Enumclaw,0.24,0.31,0.45,4103,1957,2146,0,53,23,30,606,16,162,3213,230,91,1448,3873,4012,2655
215,2015,Ephrata,0.33,0.245,0.42500000000000004,2426,1179,1247,0,4,13,12,751,1,49,1596,260,62,1440,2166,2364,986
216,2015,Everett,0.3025,0.3325,0.3625,20151,9918,10233,0,114,2573,806,3688,253,1451,11265,2532,1082,8813,17619,19069,11338
217,2015,Evergreen (Clark),0.275,0.2575,0.4725,26240,12646,13594,0,143,1705,698,5335,492,2104,15762,3225,1320,13726,23015,24920,12514
218,2015,Federal Way,0.27,0.364,0.366,23571,11412,12159,0,143,2658,2943,6741,1151,2995,6940,3958,1306,15248,19613,22265,8323
219,2015,Ferndale,0.375,0.3,0.325,4841,2362,2479,0,417,162,44,890,7,288,3033,288,962,2342,4553,3879,2499
220,2015,Fife,0.35,0.26,0.39,3700,1807,1893,0,32,290,139,732,150,473,1884,401,0,1773,3299,3700,1927
221,2015,Finley,0.28,0.12,0.6,911,425,486,0,3,2,4,394,0,29,479,138,0,700,773,911,211
222,2015,Franklin Pierce,0.21,0.2966666666666667,0.49666666666666665,7889,3848,4041,0,58,510,810,2067,427,1121,2895,687,1548,6456,7202,6341,1433
223,2015,Goldendale,0.38,0.15,0.46,884,406,478,0,41,8,5,124,2,43,659,34,10,536,850,874,348
224,2015,Grandview,0.28,0.2,0.52,3787,1905,1882,0,1,3,2,3488,0,14,279,1298,1,3253,2489,3786,534
225,2015,Granger,0.2,0.32,0.48,1594,763,831,0,42,0,2,1480,0,17,53,585,0,1407,1009,1594,187
226,2015,Granite Falls,0.275,0.16499999999999998,0.56,2049,974,1075,0,37,13,23,201,6,107,1662,49,0,982,2000,2049,1067
227,2015,Highland,0.33,0.19,0.48,1175,554,621,0,6,4,5,864,0,26,270,326,94,956,849,1081,219
228,2015,Highline,0.28375,0.29125,0.425,19930,9533,10397,0,162,2867,2663,7561,814,1268,4595,5218,593,14481,14712,19337,5449
229,2015,Hockinson,0.25,0.45,0.29,1890,918,972,0,8,45,14,89,1,52,1681,35,210,417,1855,1680,1473
230,2015,Hoquiam,0.54,0.13,0.33,1730,844,886,0,104,12,31,301,1,84,1197,69,40,1150,1661,1690,580
231,2015,Issaquah,0.20750000000000002,0.6625,0.1325,19882,9742,10140,0,39,5126,335,1579,58,1366,11379,1169,722,1879,18713,19160,18003
232,2015,Kalama,0.25,0.22,0.52,933,429,504,0,7,11,6,51,5,14,839,29,16,349,904,917,584
233,2015,Kelso,0.375,0.15,0.47,4984,2511,2473,0,66,52,18,827,47,335,3639,308,98,3014,4676,4886,1970
234,2015,Kennewick,0.3,0.26249999999999996,0.435,17937,8577,9360,0,75,375,408,6552,38,593,9896,2499,246,10853,15438,17691,7084
235,2015,Kent,0.35000000000000003,0.32166666666666666,0.33166666666666667,28063,13424,14639,0,109,5022,3381,6128,707,2717,9999,5233,398,15273,22830,27665,12790
236,2015,Kettle Falls,0.19,0.22,0.59,912,465,447,0,16,10,9,57,2,31,787,3,26,480,909,886,432
237,2015,Kittitas,0.16,0.5,0.34,666,320,346,0,1,8,4,155,1,9,488,56,1,327,610,665,339
238,2015,La Center,0.37,0.275,0.355,1642,788,854,0,5,15,10,106,0,28,1478,38,0,459,1604,1642,1183
239,2015,La Conner,0.32,0.38,0.3,637,312,325,0,222,5,2,62,2,23,320,84,15,353,553,622,284
240,2015,Lake Chelan,0.29500000000000004,0.29500000000000004,0.405,1474,691,783,0,2,5,3,797,0,16,651,400,29,985,1074,1445,489
241,2015,Lake Stevens,0.32,0.28,0.4,8655,4089,4566,0,38,279,143,1145,32,695,6323,338,350,2865,8317,8305,5790
242,2015,Lake Washington,0.17,0.655,0.17500000000000002,28126,13598,14528,0,56,6622,462,3068,34,2135,15736,2556,1606,3878,25570,26520,24248
243,2015,Lakewood,0.35,0.28,0.37,2347,1125,1222,0,25,48,32,359,20,153,1710,121,23,925,2226,2324,1422
244,2015,Liberty,0.29,0.38,0.33,441,205,236,0,3,2,2,28,0,13,393,4,12,170,437,429,271
245,2015,Longview,0.3566666666666667,0.25666666666666665,0.38666666666666666,6873,3389,3484,0,80,117,67,1399,35,489,4686,411,215,4453,6462,6658,2420
246,2015,Lynden,0.295,0.235,0.47,3113,1520,1593,0,14,69,38,742,4,121,2125,300,0,1195,2813,3113,1918
247,2015,Mabton,0.15,0.17,0.68,994,498,496,0,3,0,0,967,0,0,24,480,0,949,514,994,45
248,2015,Manson,0.23,0.37,0.4,696,329,367,0,6,4,4,482,0,2,198,285,0,557,411,696,139
249,2015,Marysville,0.36,0.22428571428571428,0.41714285714285715,11331,5572,5759,0,689,572,174,2462,90,1161,6183,961,272,6027,10370,11059,5304
250,2015,Mead,0.3125,0.3775,0.3125,9928,4822,5106,0,45,90,128,583,74,771,8237,270,680,3242,9658,9248,6686
251,2015,Medical Lake,0.27,0.30000000000000004,0.43000000000000005,2003,933,1070,0,10,20,64,215,8,185,1501,18,14,810,1985,1989,1193
252,2015,Mercer Island,0.09,0.73,0.18,4457,2087,2370,0,9,865,44,186,8,358,2987,111,704,188,4346,3753,4269
253,2015,Meridian,0.34,0.32,0.33,1755,824,931,0,19,82,23,316,4,67,1244,137,8,700,1618,1747,1055
254,2015,Methow Valley,0.15000000000000002,0.44499999999999995,0.41000000000000003,620,295,325,0,5,4,1,39,0,15,556,9,79,305,611,541,315
255,2015,Monroe,0.25,0.32,0.43,7022,3432,3590,0,52,161,74,1381,15,357,4980,550,1163,2054,6472,5859,4968
256,2015,Montesano,0.44,0.19,0.38,1406,683,723,0,23,14,0,151,1,88,1129,26,1,560,1380,1405,846
257,2015,Moses Lake,0.31,0.24,0.44,8316,4105,4211,0,47,76,100,3785,4,199,4105,1115,279,5511,7201,8037,2805
258,2015,Mount Adams,0.16,0.29,0.55,961,455,506,0,514,0,0,364,0,47,36,127,1,849,834,960,112
259,2015,Mount Vernon,0.32,0.295,0.39,6716,3316,3400,0,41,114,59,3681,48,154,2619,1676,0,4589,5040,6716,2127
260,2015,Mukilteo,0.33666666666666667,0.33666666666666667,0.32666666666666666,15614,7442,8172,0,68,2317,939,4384,186,1392,6328,2994,446,8398,12620,15168,7216
261,2015,Napavine,0.43,0.09,0.48,795,364,431,0,4,6,4,101,0,32,648,25,0,399,770,795,396
262,2015,Newport,0.20500000000000002,0.255,0.55,1086,519,567,0,6,5,2,48,1,60,964,8,137,675,1078,949,411
263,2015,Nine Mile Falls,0.39,0.35,0.25,1453,727,726,0,27,6,10,71,3,84,1252,0,55,475,1453,1398,978
264,2015,Nooksack Valley,0.39,0.1,0.51,1674,817,857,0,63,13,5,559,1,93,940,227,0,978,1447,1674,696
265,2015,North Franklin,0.195,0.29000000000000004,0.515,2143,1018,1125,0,3,26,6,1525,1,27,555,656,35,1655,1487,2108,488
266,2015,North Kitsap,0.29666666666666663,0.42,0.2833333333333334,6155,3067,3088,0,255,178,65,782,21,684,4170,202,295,2241,5953,5860,3914
267,2015,North Mason,0.27,0.22999999999999998,0.495,2178,1076,1102,0,22,22,14,412,12,148,1548,184,24,1246,1994,2154,932
268,2015,Northshore,0.23800000000000004,0.46399999999999997,0.296,21564,10447,11117,0,74,3365,409,2741,50,1803,13122,1507,742,3713,20057,20822,17851
269,2015,Oak Harbor,0.28500000000000003,0.24,0.475,5898,2840,3058,0,29,449,275,864,49,624,3608,202,250,2623,5696,5648,3275
270,2015,Ocean Beach,0.27,0.19,0.53,1024,479,545,0,13,10,0,197,0,64,740,64,28,704,960,996,320
271,2015,Ocosta,0.33,0.11,0.56,628,298,330,0,28,5,3,120,0,68,404,50,13,472,578,615,156
272,2015,Okanogan,0.2,0.37,0.43,1113,539,574,0,97,5,3,274,0,64,670,104,3,687,1009,1110,426
273,2015,Olympia,0.24,0.49,0.26666666666666666,9973,4790,5183,0,40,755,228,1046,19,987,6893,234,44,3248,9739,9929,6725
274,2015,Omak,0.235,0.255,0.5,5522,2787,2735,0,436,173,240,680,48,168,3776,164,16,2495,5358,5506,3027
275,2015,Onalaska,0.39,0.2,0.41,785,372,413,0,7,3,2,89,0,35,649,30,0,472,755,785,313
276,2015,Oroville,0.22,0.22,0.56,537,249,288,0,11,8,1,196,2,12,307,78,13,391,459,524,146
277,2015,Orting,0.25,0.22,0.53,2506,1238,1268,0,17,31,30,334,14,200,1880,46,26,1007,2460,2480,1499
278,2015,Othello,0.335,0.245,0.42,4316,2071,2245,0,0,9,4,3820,0,16,467,1704,80,3610,2612,4236,706
279,2015,Pasco,0.315,0.15500000000000003,0.53,17515,8489,9026,0,14,190,206,12324,29,400,4352,6135,576,13088,11380,16939,4427
280,2015,Peninsula,0.21333333333333335,0.44999999999999996,0.33666666666666667,9068,4440,4628,0,45,174,71,701,25,760,7292,103,320,2403,8965,8748,6665
281,2015,Port Angeles,0.245,0.27,0.485,3836,1858,1978,0,172,60,36,322,5,415,2826,46,77,2200,3790,3759,1636
282,2015,Port Townsend,0.22,0.44,0.34,1175,578,597,0,15,27,14,85,6,69,959,18,0,657,1157,1175,518
283,2015,Prosser,0.25,0.33999999999999997,0.41500000000000004,2829,1395,1434,0,18,49,20,1743,6,17,968,680,61,1963,2149,2768,866
284,2015,Pullman,0.11,0.65,0.24,2844,1360,1484,0,14,295,76,297,9,194,1959,181,58,966,2663,2786,1878
285,2015,Puyallup,0.2475,0.335,0.4125,22142,10654,11488,0,194,1055,834,3407,311,2668,13673,1000,856,8417,21142,21286,13725
286,2015,Quillayute Valley,0.29,0.11,0.6,3133,1722,1411,0,127,48,113,608,15,224,1998,129,45,1887,3004,3088,1246
287,2015,Quincy,0.355,0.21000000000000002,0.435,2905,1460,1445,0,0,2,7,2540,0,9,346,1180,61,2530,1725,2844,375
288,2015,Rainier,0.3,0.28,0.42,828,408,420,0,6,6,5,79,2,47,683,4,0,453,824,828,375
289,2015,Raymond,0.49,0.24,0.27,665,324,341,0,21,31,1,158,2,14,438,86,0,389,579,665,276
290,2015,Reardan-Edwall,0.38,0.25,0.37,555,274,281,0,22,1,1,21,0,37,473,22,0,250,533,555,305
291,2015,Renton,0.40750000000000003,0.2875,0.3025,16061,7777,8284,0,100,3985,2623,3702,149,1247,4255,2512,1015,9051,13549,15046,7010
292,2015,Richland,0.25,0.39,0.36,13343,6529,6814,0,72,502,279,2229,27,503,9731,550,337,5135,12793,13006,8208
293,2015,Ridgefield,0.39,0.4,0.22,2514,1242,1272,0,6,39,15,279,8,137,2030,92,132,806,2422,2382,1708
294,2015,Ritzville,0.19,0.33,0.48,394,181,213,0,6,7,7,36,0,2,336,3,0,177,391,394,217
295,2015,Riverside,0.335,0.12,0.545,1492,703,789,0,38,10,11,67,4,35,1327,10,20,823,1482,1472,669
296,2015,Riverview,0.26,0.47,0.27,3263,1651,1612,0,18,91,15,433,10,150,2546,126,29,593,3137,3234,2670
297,2015,Rochester,0.32,0.15,0.53,2203,1043,1160,0,74,11,10,457,1,137,1513,122,113,1219,2081,2090,984
298,2015,Royal,0.31,0.29,0.4,1746,866,880,0,3,1,1,1454,0,3,284,798,0,1318,948,1746,428
299,2015,San Juan Island,0.19,0.535,0.275,797,398,399,0,5,12,4,133,1,41,601,29,52,375,768,745,422
300,2015,Sedro-Woolley,0.33,0.19,0.47,4383,2130,2253,0,100,42,30,844,5,149,3213,287,56,2415,4096,4327,1968
301,2015,Selah,0.37,0.305,0.33,3693,1799,1894,0,26,13,19,1005,3,90,2537,271,128,1946,3422,3565,1747
302,2015,Sequim,0.27,0.3,0.43,2851,1391,1460,0,46,47,15,303,5,198,2237,47,74,1420,2804,2777,1431
303,2015,Shelton,0.26,0.175,0.565,4316,2059,2257,0,143,26,22,1241,6,293,2585,506,128,3029,3810,4188,1287
304,2015,Shoreline,0.31,0.5,0.19000000000000003,9374,4506,4868,0,42,1266,671,1182,49,1084,5080,608,717,2822,8766,8657,6552
305,2015,Snohomish,0.3,0.3466666666666667,0.35333333333333333,10112,4918,5194,0,60,387,93,1024,19,576,7953,334,1224,2349,9778,8888,7763
306,2015,Snoqualmie Valley,0.20500000000000002,0.53,0.27,6901,3260,3641,0,32,330,52,467,14,318,5688,172,271,945,6729,6630,5956
307,2015,South Bend,0.54,0.15000000000000002,0.31,670,335,335,0,20,17,2,269,2,74,286,97,0,440,573,670,230
308,2015,South Kitsap,0.29000000000000004,0.25,0.45999999999999996,9591,4594,4997,0,88,284,123,1010,143,1099,6844,136,340,4260,9455,9251,5331
309,2015,South Whidbey,0.20500000000000002,0.385,0.41000000000000003,1406,719,687,0,14,38,13,95,3,47,1196,6,2,458,1400,1404,948
310,2015,Spokane,0.2542857142857143,0.3257142857142857,0.4185714285714286,30371,14681,15690,0,425,751,870,3088,465,3930,20842,1604,837,18189,28767,29534,12182
311,2015,Stanwood-Camano,0.26,0.355,0.385,4504,2188,2316,0,36,54,40,412,11,207,3744,96,126,1349,4408,4378,3155
312,2015,Stevenson-Carson,0.185,0.31,0.5,921,443,478,0,17,4,9,126,2,48,715,18,36,492,903,885,429
313,2015,Sumner,0.23333333333333336,0.3866666666666667,0.38000000000000006,9447,4675,4772,0,76,176,90,1228,29,794,7054,333,290,3361,9114,9157,6086
314,2015,Sunnyside,0.28,0.16,0.56,6807,3281,3526,0,1,3,8,6264,0,66,465,2114,36,5943,4693,6771,864
315,2015,Tacoma,0.2475,0.3675,0.3875,30527,15060,15467,0,358,2912,5406,6049,791,2624,12387,2859,1392,17891,27668,29135,12636
316,2015,Tahoma,0.3,0.44,0.26,8243,3994,4249,0,30,331,136,812,67,693,6174,165,104,1320,8078,8139,6923
317,2015,Tenino,0.3,0.22,0.48,1214,552,662,0,13,3,6,85,2,47,1057,8,18,598,1206,1196,616
318,2015,Toledo,0.265,0.355,0.38,757,362,395,0,17,6,4,84,1,42,603,21,6,421,736,751,336
319,2015,Tonasket,0.16,0.25,0.58,1156,557,599,0,7,2,4,445,0,40,658,179,0,796,977,1156,360
320,2015,Toppenish,0.20500000000000002,0.29000000000000004,0.505,4553,2248,2305,0,533,18,20,3389,1,42,550,1660,0,3769,2893,4553,784
321,2015,Tukwila,0.33,0.27,0.39,3158,1526,1632,0,26,874,647,914,105,209,383,1152,104,2566,2006,3054,592
322,2015,Tumwater,0.29666666666666663,0.3433333333333333,0.36000000000000004,6285,3049,3236,0,35,180,110,701,38,570,4651,112,46,2149,6173,6239,4136
323,2015,University Place,0.32,0.39,0.29,5669,2788,2881,0,30,535,523,773,53,893,2862,261,107,2383,5408,5562,3286
324,2015,Vancouver,0.26,0.3466666666666667,0.39166666666666666,23509,11533,11976,0,121,780,602,5813,433,1704,14056,3049,254,12942,20460,23255,10567
325,2015,Vashon Island,0.10500000000000001,0.615,0.28,1608,756,852,0,7,39,17,190,1,146,1208,56,55,419,1552,1553,1189
326,2015,Wahluke,0.39,0.155,0.45499999999999996,2481,1227,1254,0,14,0,1,2386,0,8,72,1418,0,2088,1063,2481,393
327,2015,Wapato,0.165,0.355,0.48,3459,1670,1789,0,704,51,1,2473,3,113,108,1095,55,3231,2364,3404,228
328,2015,Warden,0.28,0.28,0.43,978,484,494,0,0,2,0,783,0,13,180,307,0,741,671,978,237
329,2015,Washougal,0.28500000000000003,0.21500000000000002,0.51,3199,1536,1663,0,15,43,23,323,4,198,2593,74,0,1365,3125,3199,1834
330,2015,Wenatchee,0.345,0.33999999999999997,0.315,7979,3832,4147,0,29,63,43,3912,5,206,3721,1864,625,5034,6115,7354,2945
331,2015,West Valley (Spokane),0.3,0.3,0.4,3824,1859,1965,0,44,47,66,304,8,269,3086,101,25,2150,3723,3799,1674
332,2015,West Valley (Yakima),0.25,0.42,0.32,5035,2440,2595,0,49,127,47,1417,12,160,3223,359,375,2234,4676,4660,2801
333,2015,White River,0.19,0.28,0.53,3661,1746,1915,0,27,29,19,348,6,212,3020,73,79,1230,3588,3582,2431
334,2015,White Salmon Valley,0.195,0.365,0.435,1300,607,693,0,10,6,4,425,1,32,822,183,16,647,1117,1284,653
335,2015,Winlock,0.33499999999999996,0.125,0.54,702,312,390,0,3,3,2,186,0,37,471,84,0,639,618,702,63
336,2015,Woodland,0.255,0.195,0.55,2343,1107,1236,0,12,10,18,460,1,52,1790,158,286,1156,2185,2057,1187
337,2015,Yakima,0.27666666666666667,0.22333333333333336,0.5033333333333333,16356,8102,8254,0,136,74,136,12637,8,415,2950,5655,470,14321,10701,15886,2035
338,2015,Yelm,0.245,0.28,0.475,5689,2754,2935,0,84,80,75,796,53,562,4039,124,0,2684,5565,5689,3005
339,2015,Zillah,0.29,0.25,0.46,1352,629,723,0,62,4,2,665,1,50,568,138,0,797,1214,1352,555
340,2016,Aberdeen,0.41000000000000003,0.1,0.49,3500,1722,1778,0,125,70,34,1111,9,238,1913,482,89,2513,3018,3411,987
341,2016,Adna,0.42,0.22,0.37,643,303,340,0,6,4,3,44,0,14,572,3,0,195,640,643,448
342,2016,Anacortes,0.31,0.425,0.265,2844,1388,1456,0,22,97,28,291,4,72,2330,68,108,827,2776,2736,2017
343,2016,Arlington,0.325,0.255,0.42,5620,2693,2927,0,63,80,52,756,18,350,4301,269,0,2021,5351,5620,3599
344,2016,Asotin-Anatone,0.18,0.36,0.46,699,353,346,0,4,7,1,40,0,36,611,0,28,240,699,671,459
345,2016,Auburn,0.29000000000000004,0.2925,0.4175,16472,8091,8381,0,212,1392,1194,4733,583,1609,6749,2897,300,9353,13575,16172,7119
346,2016,Bainbridge Island,0.15,0.645,0.2,3897,1858,2039,0,21,123,20,298,4,326,3105,40,0,322,3857,3897,3575
347,2016,Battle Ground,0.292,0.252,0.45199999999999996,13478,6518,6960,0,47,289,80,1182,50,652,11176,788,219,4961,12690,13259,8517
348,2016,Bellevue,0.194,0.632,0.17400000000000002,21378,10161,11217,0,21,8210,577,2532,42,1932,8064,2871,1995,4147,18507,19383,17231
349,2016,Bellingham,0.2925,0.41000000000000003,0.2975,11556,5541,6015,0,116,663,198,1818,41,870,7850,790,192,4544,10766,11364,7012
350,2016,Bethel,0.2625,0.225,0.515,19418,9266,10152,0,227,756,1415,3237,683,2384,10655,769,995,10849,18649,18423,8569
351,2016,Blaine,0.35,0.31,0.34,2261,1071,1190,0,24,79,38,281,18,134,1687,90,165,1104,2171,2096,1157
352,2016,Bremerton,0.29000000000000004,0.195,0.515,5111,2407,2704,0,45,190,297,998,83,806,2692,284,75,3227,4827,5036,1884
353,2016,Brewster,0.425,0.255,0.32499999999999996,981,448,533,0,5,1,1,887,0,5,82,443,7,930,538,974,51
354,2016,Burlington-Edison,0.33,0.29000000000000004,0.38,3738,1787,1951,0,28,73,30,1545,9,127,1916,812,157,2011,2926,3581,1727
355,2016,Camas,0.275,0.445,0.275,7222,3559,3663,0,28,500,62,605,19,578,5430,215,128,1219,7007,7094,6003
356,2016,Cape Flattery,0.26,0.16,0.58,504,263,241,0,237,0,0,95,0,103,69,1,3,376,503,501,128
357,2016,Cascade,0.34,0.39,0.27,1362,687,675,0,8,6,7,396,0,25,911,184,0,663,1178,1362,699
358,2016,Central Kitsap,0.3725,0.2775,0.35,11093,5390,5703,0,45,543,354,1433,141,1926,6651,327,145,3485,10766,10948,7608
359,2016,Central Valley,0.25333333333333335,0.3333333333333333,0.41333333333333333,13898,6633,7265,0,144,222,243,1076,131,597,11485,486,1699,5821,13412,12199,8077
360,2016,Centralia,0.355,0.13,0.515,3631,1757,1874,0,22,24,32,1247,7,134,2164,449,73,2782,3182,3558,849
361,2016,Chehalis,0.405,0.245,0.35,3045,1374,1671,0,19,36,59,584,5,188,2154,160,15,1539,2885,3030,1506
362,2016,Cheney,0.21000000000000002,0.39,0.4,4775,2255,2520,0,87,86,81,482,33,299,3707,135,242,2389,4640,4533,2386
363,2016,Chewelah,0.15666666666666665,0.2866666666666667,0.5566666666666666,802,377,425,0,4,6,6,25,1,25,735,0,40,501,802,762,301
364,2016,Chimacum,0.28,0.23,0.49,1066,517,549,0,12,14,7,87,1,82,863,14,50,541,1052,1016,525
365,2016,Clarkston,0.13,0.435,0.435,2719,1355,1364,0,52,26,41,207,2,114,2277,25,19,1643,2694,2700,1076
366,2016,Cle Elum-Roslyn,0.18,0.355,0.46499999999999997,831,392,439,0,4,10,3,83,0,43,687,29,59,360,802,772,471
367,2016,Clover Park,0.2233333333333333,0.27,0.5033333333333333,13583,6542,7041,0,67,558,1681,4451,632,1791,4400,1572,66,9769,12011,13517,3814
368,2016,Colfax,0.22,0.47,0.31,610,285,325,0,2,4,1,25,0,40,538,0,0,204,610,610,406
369,2016,Columbia (Walla Walla),0.43,0.21,0.36,805,402,403,0,6,1,6,291,0,20,479,124,34,440,681,771,365
370,2016,Colville,0.20500000000000002,0.275,0.525,1740,869,871,0,31,10,8,86,1,75,1529,28,0,933,1712,1740,807
371,2016,Concrete,0.325,0.175,0.5,562,266,296,0,16,3,0,49,1,7,486,0,0,395,562,562,167
372,2016,Coupeville,0.28,0.29,0.43,991,518,473,0,0,12,11,141,2,118,707,31,1,365,960,990,626
373,2016,Davenport,0.31,0.31,0.37,622,329,293,0,12,6,1,20,0,11,572,6,1,380,616,621,242
374,2016,Deer Park,0.25,0.16,0.59,2572,1239,1333,0,65,14,38,135,2,18,2300,14,252,1307,2558,2320,1265
375,2016,East Valley (Spokane),0.3,0.22,0.49,4280,2061,2219,0,47,51,56,436,47,310,3333,123,153,2458,4157,4127,1822
376,2016,East Valley (Yakima),0.31,0.19,0.5,3225,1546,1679,0,29,25,28,1530,3,75,1535,423,53,1938,2802,3172,1287
377,2016,Eastmont,0.35,0.22,0.43,6154,2999,3155,0,21,44,20,2801,8,179,3081,1147,322,3424,5007,5832,2730
378,2016,Eatonville,0.14,0.26,0.6,1910,933,977,0,15,13,13,130,6,120,1613,9,28,857,1901,1882,1053
379,2016,Edmonds,0.346,0.386,0.266,21309,10213,11096,0,102,2746,1334,4319,161,2191,10456,2742,870,8584,18567,20439,12725
380,2016,Ellensburg,0.10500000000000001,0.44,0.45,3344,1627,1717,0,29,56,37,608,6,60,2548,246,221,1332,3098,3123,2012
381,2016,Elma,0.32499999999999996,0.105,0.5700000000000001,1437,706,731,0,15,12,7,291,0,125,987,116,22,1140,1321,1415,297
382,2016,Enumclaw,0.22,0.38,0.4,4077,1969,2108,0,47,24,29,619,15,168,3175,231,119,1411,3846,3958,2666
383,2016,Ephrata,0.28500000000000003,0.26,0.45499999999999996,2500,1197,1303,0,3,18,13,774,1,49,1642,282,103,1478,2218,2397,1022
384,2016,Everett,0.29500000000000004,0.37,0.3325,20465,10012,10453,0,111,2697,861,3833,284,1531,11148,2677,1085,8663,17788,19380,11802
385,2016,Evergreen (Clark),0.262,0.278,0.45600000000000007,26262,12654,13608,0,135,1663,716,5710,488,2135,15415,3572,1339,13499,22690,24923,12763
386,2016,Federal Way,0.268,0.376,0.354,23547,11404,12143,0,129,2635,3038,7029,1227,3032,6457,3956,936,15432,19591,22611,8115
387,2016,Ferndale,0.34,0.31,0.355,4834,2339,2495,0,409,161,48,914,9,345,2948,328,814,2281,4506,4020,2553
388,2016,Fife,0.29,0.31,0.4,3713,1819,1894,0,24,296,146,714,171,524,1838,542,0,1674,3171,3713,2039
389,2016,Finley,0.27,0.08,0.65,930,432,498,0,2,4,5,417,0,34,468,160,0,712,770,930,218
390,2016,Franklin Pierce,0.19666666666666668,0.3066666666666667,0.5033333333333333,7986,3905,4081,0,79,488,801,2150,450,1165,2853,773,1054,6410,7213,6932,1576
391,2016,Goldendale,0.22,0.18,0.6,952,450,502,0,44,8,5,145,1,40,709,35,12,578,917,940,374
392,2016,Grand Coulee Dam,0.15,0.35,0.5,759,364,395,0,285,2,4,84,3,166,215,112,0,549,647,759,210
393,2016,Grandview,0.30500000000000005,0.20500000000000002,0.495,3790,1870,1920,0,2,2,3,3497,0,12,274,1326,1,3273,2464,3789,517
394,2016,Granger,0.15,0.31,0.53,1591,777,814,0,44,0,1,1471,0,18,57,565,0,1368,1026,1591,223
395,2016,Granite Falls,0.25,0.19,0.56,1993,928,1065,0,43,10,26,205,6,115,1588,62,0,991,1931,1993,1002
396,2016,Highland,0.38,0.18,0.44,1206,587,619,0,3,2,4,904,0,21,272,351,75,982,855,1131,224
397,2016,Highline,0.2788888888888889,0.27,0.4488888888888889,20072,9617,10455,0,168,2861,2831,7613,858,1192,4549,5548,623,14277,14524,19449,5795
398,2016,Hockinson,0.29,0.43,0.28,1888,912,976,0,11,44,15,93,1,59,1665,36,82,384,1852,1806,1504
399,2016,Hoquiam,0.425,0.14,0.44,1617,777,840,0,91,14,23,279,1,103,1106,64,36,1102,1553,1581,515
400,2016,Issaquah,0.1875,0.6775,0.1325,20540,10065,10475,0,45,5581,359,1712,52,1474,11317,1307,813,1964,19233,19727,18576
401,2016,Kalama,0.41,0.15,0.44,974,445,529,0,10,10,11,66,5,17,855,33,15,371,941,959,603
402,2016,Kelso,0.33,0.155,0.515,5023,2481,2542,0,66,51,16,863,55,312,3660,326,121,3054,4697,4902,1969
403,2016,Kennewick,0.2975,0.265,0.435,18437,8817,9620,0,65,373,427,6603,34,692,10243,2615,252,10919,15822,18185,7518
404,2016,Kent,0.312,0.38,0.306,28039,13501,14538,0,111,5209,3275,6302,737,2668,9737,5428,353,14920,22611,27686,13119
405,2016,Kettle Falls,0.195,0.165,0.64,969,493,476,0,18,6,8,73,3,42,819,1,37,505,968,932,464
406,2016,Kittitas,0.23,0.4,0.37,666,324,342,0,0,6,6,150,0,8,496,57,0,318,609,666,348
407,2016,La Center,0.39,0.28,0.335,1687,810,877,0,5,13,8,93,2,39,1527,42,0,431,1645,1687,1256
408,2016,La Conner,0.31,0.51,0.18,614,309,305,0,243,8,2,55,1,25,280,85,11,377,529,603,237
409,2016,Lake Chelan,0.245,0.48,0.28500000000000003,1493,682,811,0,2,6,7,829,0,18,631,424,40,1002,1069,1453,491
410,2016,Lake Stevens,0.33,0.29,0.38,8950,4273,4677,0,36,306,163,1224,34,762,6425,359,364,2732,8591,8586,6218
411,2016,Lake Washington,0.19833333333333333,0.6233333333333333,0.17833333333333334,29724,14323,15401,0,60,7737,493,3131,32,2305,15966,2873,1745,3786,26851,27979,25938
412,2016,Lake Washington Institute of Technology,0.27,0.1,0.63,654,275,379,0,3,26,18,73,2,30,353,0,0,0,654,654,654
413,2016,Lakewood,0.38,0.16,0.46,2447,1164,1283,0,19,39,40,397,31,205,1716,132,35,978,2315,2412,1469
414,2016,Liberty,0.18,0.55,0.27,470,215,255,0,2,4,3,37,0,13,411,5,20,180,465,450,290
415,2016,Longview,0.3233333333333333,0.2333333333333333,0.4466666666666666,6834,3389,3445,0,89,116,73,1386,33,508,4629,509,242,4420,6325,6592,2414
416,2016,Lynden,0.375,0.255,0.37,3274,1575,1699,0,21,84,35,790,2,138,2204,322,0,1207,2952,3274,2067
417,2016,Mabton,0.31,0.23,0.46,945,479,466,0,3,0,0,923,0,0,19,425,0,895,520,945,50
418,2016,Manson,0.33,0.2,0.47,698,330,368,0,9,3,3,467,0,2,214,43,0,542,655,698,156
419,2016,Marysville,0.37142857142857144,0.21428571428571427,0.41285714285714287,11318,5537,5781,0,704,572,202,2511,83,1215,6031,1442,268,5944,9876,11050,5374
420,2016,Mead,0.2225,0.4225,0.355,10146,4960,5186,0,49,91,139,601,96,810,8360,257,702,3328,9889,9444,6818
421,2016,Medical Lake,0.26,0.22999999999999998,0.51,1920,900,1020,0,6,17,59,228,12,168,1430,18,22,770,1902,1898,1150
422,2016,Mercer Island,0.09,0.77,0.15,4483,2085,2398,0,9,899,48,196,7,385,2939,150,711,175,4333,3772,4308
423,2016,Meridian,0.39,0.29,0.33,1736,828,908,0,9,91,14,335,4,89,1194,155,7,683,1581,1729,1053
424,2016,Methow Valley,0.125,0.51,0.375,626,301,325,0,5,6,2,36,0,18,557,7,92,287,619,534,339
425,2016,Monroe,0.28500000000000003,0.29500000000000004,0.42000000000000004,7083,3482,3601,0,43,159,83,1476,16,360,4945,600,1252,2044,6483,5831,5039
426,2016,Montesano,0.43,0.32,0.25,1442,690,752,0,21,12,1,166,0,99,1143,28,0,563,1414,1442,879
427,2016,Moses Lake,0.32,0.27,0.41,8687,4285,4402,0,31,69,98,4055,4,213,4217,1338,309,5786,7349,8378,2901
428,2016,Mount Adams,0.09,0.37,0.54,945,450,495,0,500,0,0,354,0,48,43,464,20,870,481,925,75
429,2016,Mount Vernon,0.26,0.28,0.46,6977,3471,3506,0,37,130,69,3756,46,145,2794,1607,4,4524,5370,6973,2453
430,2016,Mukilteo,0.32,0.34,0.33666666666666667,15814,7570,8244,0,54,2314,1067,4537,165,1503,6174,3077,426,8470,12737,15388,7344
431,2016,Napavine,0.36,0.12,0.52,810,370,440,0,2,4,3,109,0,38,654,27,0,390,783,810,420
432,2016,Newport,0.24,0.30000000000000004,0.45999999999999996,1094,506,588,0,6,6,1,62,2,56,961,5,138,715,1089,956,379
433,2016,Nine Mile Falls,0.45,0.31,0.24,1442,711,731,0,19,7,12,81,3,87,1233,2,56,476,1440,1386,966
434,2016,Nooksack Valley,0.39,0.29,0.32,1775,855,920,0,71,18,8,599,1,92,986,264,0,1056,1511,1775,719
435,2016,North Franklin,0.29000000000000004,0.19,0.52,2179,1027,1152,0,0,24,5,1564,0,22,564,772,34,1659,1407,2145,520
436,2016,North Kitsap,0.30333333333333334,0.34,0.35666666666666663,5974,2945,3029,0,261,179,52,791,20,673,3998,229,293,2093,5745,5681,3881
437,2016,North Mason,0.29500000000000004,0.19,0.515,2217,1079,1138,0,24,15,14,452,12,156,1544,207,25,1301,2010,2192,916
438,2016,Northshore,0.25,0.46799999999999997,0.282,22047,10688,11359,0,70,3709,421,2767,52,1905,13123,1706,803,3494,20341,21244,18553
439,2016,Oak Harbor,0.22,0.31,0.47,5963,2849,3114,0,19,422,254,941,49,679,3599,263,272,2539,5700,5691,3424
440,2016,Ocean Beach,0.17,0.26,0.57,1022,479,543,0,17,10,3,181,1,64,746,67,35,700,955,987,322
441,2016,Ocosta,0.45,0.16,0.39,623,295,328,0,23,5,4,123,0,63,405,49,31,491,574,592,132
442,2016,Okanogan,0.35,0.32,0.33,1131,544,587,0,107,5,4,305,1,64,644,116,8,703,1015,1123,428
443,2016,Olympia,0.20666666666666667,0.5133333333333333,0.27999999999999997,10055,4816,5239,0,54,723,226,1112,23,1053,6864,233,58,3222,9822,9997,6833
444,2016,Omak,0.125,0.16999999999999998,0.705,5471,2834,2637,0,464,192,346,645,62,160,3602,189,14,2321,5282,5457,3150
445,2016,Onalaska,0.51,0.16,0.33,816,390,426,0,5,4,0,91,0,36,680,32,0,480,784,816,336
446,2016,Orcas Island,0.12,0.56,0.32,801,420,381,0,4,18,15,77,4,49,634,47,0,225,754,801,576
447,2016,Oroville,0.3,0.13,0.57,596,287,309,0,10,6,1,228,2,16,333,90,14,429,506,582,167
448,2016,Orting,0.2,0.29,0.51,2619,1274,1345,0,12,34,31,359,8,223,1952,38,41,980,2581,2578,1639
449,2016,Othello,0.315,0.21000000000000002,0.47,4414,2104,2310,0,0,9,4,3935,1,18,447,1937,68,3733,2477,4346,681
450,2016,Pasco,0.365,0.155,0.485,17983,8723,9260,0,16,180,220,12696,31,453,4387,5447,593,13345,12536,17390,4638
451,2016,Peninsula,0.23666666666666666,0.4466666666666667,0.31666666666666665,9173,4500,4673,0,41,165,83,744,20,789,7331,140,337,2456,9033,8836,6717
452,2016,Port Angeles,0.3,0.235,0.45999999999999996,3827,1883,1944,0,195,62,28,324,8,410,2800,45,161,2156,3782,3666,1671
453,2016,Port Townsend,0.23,0.36,0.42,1189,593,596,0,14,25,13,93,5,62,977,28,0,635,1161,1189,554
454,2016,Prosser,0.28,0.29000000000000004,0.425,2779,1382,1397,0,12,35,13,1732,3,74,888,619,49,1999,2160,2730,780
455,2016,Pullman,0.11,0.59,0.3,2870,1365,1505,0,11,289,69,321,6,203,1971,194,77,952,2676,2793,1918
456,2016,Puyallup,0.2625,0.335,0.40249999999999997,22471,10756,11715,0,200,1120,844,3673,292,2785,13557,1131,959,8197,21340,21512,14274
457,2016,Quillayute Valley,0.28500000000000003,0.155,0.565,3063,1688,1375,0,126,50,92,675,16,280,1824,128,39,1850,2935,3024,1213
458,2016,Quincy,0.305,0.27,0.42,2985,1483,1502,0,2,3,7,2624,0,7,339,1285,85,2595,1700,2900,390
459,2016,Rainier,0.22,0.3,0.48,826,399,427,0,3,6,4,80,2,63,668,4,0,426,822,826,400
460,2016,Raymond,0.36,0.2,0.43,669,333,336,0,18,37,4,165,2,22,421,83,0,402,586,669,267
461,2016,Reardan-Edwall,0.27,0.37,0.37,585,291,294,0,23,0,0,24,0,30,508,8,0,238,577,585,347
462,2016,Renton,0.32,0.325,0.3525,16046,7808,8238,0,89,4051,2474,3741,144,1299,4248,2748,1100,8685,13298,14946,7361
463,2016,Richland,0.25,0.35,0.4,13699,6709,6990,0,63,515,283,2362,27,588,9861,594,349,5459,13105,13350,8240
464,2016,Ridgefield,0.38,0.3,0.32,2823,1395,1428,0,6,39,16,318,10,162,2272,93,72,791,2730,2751,2032
465,2016,Ritzville,0.19,0.3,0.52,376,178,198,0,8,7,3,42,0,6,309,1,0,183,375,376,193
466,2016,Riverside,0.315,0.21,0.475,1500,701,799,0,39,8,7,80,4,36,1326,11,15,846,1489,1485,654
467,2016,Riverview,0.22,0.47,0.315,3364,1689,1675,0,14,88,19,425,9,145,2663,143,27,531,3221,3337,2833
468,2016,Rochester,0.395,0.095,0.51,2261,1064,1197,0,81,11,8,483,3,146,1529,170,130,1264,2091,2131,997
469,2016,Royal,0.42,0.21,0.37,1758,859,899,0,3,1,1,1455,0,3,295,819,0,1352,939,1758,406
470,2016,San Juan Island,0.16,0.555,0.29,823,415,408,0,6,13,3,144,1,40,616,32,23,374,791,800,449
471,2016,Sedro-Woolley,0.18333333333333335,0.19000000000000003,0.6266666666666666,4463,2184,2279,0,101,38,32,896,10,153,3233,336,51,2486,4127,4412,1977
472,2016,Selah,0.32,0.28,0.41000000000000003,3806,1842,1964,0,29,18,19,1094,3,94,2549,336,166,1982,3470,3640,1824
473,2016,Sequim,0.24,0.22,0.53,2870,1402,1468,0,51,44,13,332,7,200,2223,49,59,1420,2821,2811,1450
474,2016,Shelton,0.225,0.16,0.61,4373,2080,2293,0,146,24,23,1331,8,352,2489,605,95,3078,3768,4278,1295
475,2016,Shoreline,0.30666666666666664,0.49,0.19999999999999998,9628,4622,5006,0,34,1294,677,1215,55,1142,5209,702,764,2745,8926,8864,6883
476,2016,Snohomish,0.29333333333333333,0.4033333333333333,0.30333333333333334,10137,4958,5179,0,53,415,87,1085,15,596,7886,357,1055,2239,9780,9082,7898
477,2016,Snoqualmie Valley,0.24,0.535,0.22499999999999998,7050,3334,3716,0,34,381,50,530,14,366,5675,197,230,891,6853,6820,6159
478,2016,South Bend,0.405,0.11499999999999999,0.475,683,330,353,0,16,19,6,273,2,71,296,102,0,471,581,683,212
479,2016,South Kitsap,0.28,0.225,0.495,9861,4714,5147,0,96,295,123,1078,148,1156,6965,187,412,4274,9674,9449,5587
480,2016,South Whidbey,0.23,0.44,0.32999999999999996,1389,706,683,0,12,34,16,86,5,54,1182,5,2,444,1384,1387,945
481,2016,Spokane,0.21571428571428572,0.39333333333333337,0.44571428571428573,30796,14929,15867,0,392,795,941,3151,518,3996,21003,1804,794,18651,28992,30002,12145
482,2016,Stanwood-Camano,0.34,0.28,0.38,4594,2217,2377,0,43,55,35,425,18,235,3783,117,136,1380,4477,4458,3214
483,2016,Stevenson-Carson,0.14,0.225,0.635,960,445,515,0,16,5,8,131,3,53,744,23,46,487,937,914,473
484,2016,Sumner,0.2833333333333334,0.3333333333333333,0.3833333333333333,9841,4834,5007,0,72,185,97,1314,34,867,7272,325,306,3291,9516,9535,6550
485,2016,Sunnyside,0.23,0.19,0.58,6825,3301,3524,0,1,1,5,6279,0,69,470,2214,33,5820,4611,6792,1005
486,2016,Tacoma,0.225,0.38125,0.395,30302,14914,15388,0,377,2866,4932,6090,857,3102,12078,3187,1387,19322,27115,28915,10980
487,2016,Tahoma,0.31,0.38,0.31,8419,4025,4394,0,29,360,165,825,67,743,6230,163,153,1210,8256,8266,7209
488,2016,Tenino,0.48,0.07,0.45,1258,567,691,0,14,4,2,93,1,57,1087,13,9,627,1245,1249,631
489,2016,Toledo,0.305,0.175,0.52,781,364,417,0,17,6,3,78,1,36,640,18,7,408,763,774,373
490,2016,Tonasket,0.19,0.38,0.42,1191,567,624,0,9,2,3,440,1,47,689,193,0,823,998,1191,368
491,2016,Toppenish,0.31000000000000005,0.195,0.495,4821,2372,2449,0,557,34,15,3503,0,38,674,1742,1,3848,3079,4820,973
492,2016,Tukwila,0.31,0.31,0.38,3088,1506,1582,0,29,881,611,888,110,199,370,1134,91,2433,1954,2997,655
493,2016,Tumwater,0.31666666666666665,0.33,0.35000000000000003,6503,3118,3385,0,42,193,100,772,33,607,4756,173,50,2174,6330,6453,4329
494,2016,University Place,0.28,0.45,0.26,5744,2809,2935,0,30,544,522,802,55,962,2829,287,226,2348,5457,5518,3396
495,2016,Vancouver,0.2671428571428572,0.3457142857142857,0.3842857142857143,23872,11619,12253,0,125,766,610,6168,463,1851,13889,3188,220,12813,20684,23652,11059
496,2016,Vashon Island,0.14500000000000002,0.6,0.26,1644,766,878,0,4,35,13,206,1,156,1229,63,49,415,1581,1595,1229
497,2016,Wahluke,0.365,0.1,0.535,2572,1251,1321,0,15,0,1,2467,0,5,84,1481,166,2524,1091,2406,48
498,2016,Wapato,0.19,0.29000000000000004,0.52,3358,1581,1777,0,668,53,1,2424,4,105,103,1132,71,3151,2226,3287,207
499,2016,Warden,0.47,0.21,0.31,993,512,481,0,0,2,4,798,0,10,179,363,2,881,630,991,112
500,2016,Washougal,0.305,0.255,0.445,3259,1571,1688,0,16,44,22,327,7,207,2636,99,0,1313,3160,3259,1946
501,2016,Wenatchee,0.38,0.265,0.355,7830,3752,4078,0,25,64,36,3935,5,195,3570,1894,588,4527,5936,7242,3303
502,2016,West Valley (Spokane),0.35,0.31,0.34,3828,1827,2001,0,36,45,71,330,6,320,3019,78,26,2094,3750,3802,1734
503,2016,West Valley (Yakima),0.29,0.38,0.33,5232,2561,2671,0,49,126,38,1554,11,179,3273,381,418,2095,4851,4814,3137
504,2016,White River,0.19,0.3,0.51,3828,1837,1991,0,25,37,28,394,4,204,3136,90,94,1227,3738,3734,2601
505,2016,White Salmon Valley,0.16,0.42500000000000004,0.41500000000000004,1303,605,698,0,10,6,2,431,1,36,817,197,16,637,1106,1287,666
506,2016,Winlock,0.37,0.095,0.53,732,336,396,0,5,3,1,183,0,43,494,86,0,594,646,732,138
507,2016,Woodland,0.265,0.24,0.495,2427,1149,1278,0,12,13,20,486,1,76,1819,182,252,1203,2245,2175,1224
508,2016,Yakima,0.2333333333333333,0.30000000000000004,0.47,16395,8091,8304,0,141,62,136,12814,16,400,2826,5548,544,13305,10847,15851,3090
509,2016,Yelm,0.225,0.25,0.525,5857,2813,3044,0,101,77,79,853,61,625,4061,138,0,2741,5719,5857,3116
510,2016,Zillah,0.27,0.35,0.39,1374,629,745,0,53,4,2,705,1,50,559,164,4,821,1210,1370,553
511,2017,Aberdeen,0.33999999999999997,0.2,0.45999999999999996,3599,1808,1791,0,113,70,30,1164,7,290,1925,463,91,2641,3136,3508,958
512,2017,Adna,0.48,0.15,0.38,646,329,317,0,5,5,3,37,0,17,579,0,27,193,646,619,453
513,2017,Anacortes,0.3,0.41000000000000003,0.29000000000000004,2799,1361,1438,0,20,97,28,280,3,81,2290,73,245,815,2726,2554,1984
514,2017,Arlington,0.305,0.28,0.41000000000000003,5704,2714,2990,0,74,65,43,798,11,435,4278,282,182,2102,5422,5522,3602
515,2017,Asotin-Anatone,0.08,0.55,0.37,659,338,321,0,3,8,1,39,0,34,574,0,31,197,659,628,462
516,2017,Auburn,0.31,0.3025,0.38749999999999996,17092,8326,8766,0,197,1520,1257,5114,687,1662,6655,3118,365,9682,13974,16727,7410
517,2017,Bainbridge Island,0.1,0.65,0.255,3931,1882,2049,0,26,129,21,298,8,338,3111,54,510,316,3877,3421,3615
518,2017,Battle Ground,0.26799999999999996,0.256,0.472,13541,6548,6993,0,57,309,102,1254,34,679,11106,893,559,4857,12648,12982,8684
519,2017,Bellevue,0.194,0.6439999999999999,0.164,21628,10384,11244,0,43,8618,641,2635,41,1950,7682,2989,2427,4062,18639,19201,17566
520,2017,Bellingham,0.2875,0.4225,0.2875,11901,5661,6240,0,115,667,237,1927,42,914,7999,862,880,4614,11039,11021,7287
521,2017,Bethel,0.20800000000000002,0.20400000000000001,0.588,20219,9580,10639,0,192,760,1417,3659,734,2681,10776,911,985,10767,19308,19234,9452
522,2017,Blaine,0.3,0.27,0.43,2285,1072,1213,0,31,79,38,289,19,151,1678,93,227,1139,2192,2058,1146
523,2017,Bremerton,0.365,0.13,0.505,5031,2450,2581,0,34,185,257,993,93,803,2666,323,189,3283,4708,4842,1748
524,2017,Brewster,0.305,0.43,0.255,998,480,518,0,6,1,1,904,0,6,80,458,13,946,540,985,52
525,2017,Burlington-Edison,0.355,0.235,0.405,3605,1694,1911,0,25,66,20,1542,12,132,1805,798,313,1964,2807,3292,1641
526,2017,Camas,0.19000000000000003,0.41333333333333333,0.3933333333333333,7263,3596,3667,0,20,526,63,647,13,619,5375,209,588,1131,7054,6675,6132
527,2017,Cape Flattery,0.4,0.31,0.29,492,250,242,0,237,2,0,90,0,103,60,0,0,384,492,492,108
528,2017,Cascade,0.3,0.34,0.36,1086,557,529,0,5,6,2,313,0,25,731,130,22,504,956,1064,582
529,2017,Castle Rock,0.34,0.17,0.49,1343,645,698,0,11,9,2,113,4,82,1122,34,22,735,1309,1321,608
530,2017,Central Kitsap,0.33999999999999997,0.29,0.3725,11362,5499,5863,0,48,476,358,1549,122,1955,6841,89,666,3808,11273,10696,7554
531,2017,Central Valley,0.23,0.37666666666666665,0.3933333333333333,14190,6772,7418,0,172,246,276,1081,170,614,11631,520,1856,5646,13670,12334,8544
532,2017,Centralia,0.38,0.14,0.485,3628,1756,1872,0,21,22,35,1279,8,136,2127,407,84,2758,3221,3544,870
533,2017,Chehalis,0.405,0.185,0.41000000000000003,3088,1414,1674,0,12,36,59,587,10,192,2192,172,77,1506,2916,3011,1582
534,2017,Cheney,0.2,0.365,0.435,4911,2330,2581,0,79,81,76,533,36,319,3787,137,395,2484,4774,4516,2427
535,2017,Chewelah,0.14666666666666667,0.24,0.6166666666666667,768,364,404,0,6,5,3,30,1,39,684,0,35,451,768,733,317
536,2017,Chimacum,0.23,0.24,0.53,989,468,521,0,10,10,5,83,1,79,801,8,58,525,981,931,464
537,2017,Clarkston,0.18,0.365,0.44999999999999996,2709,1348,1361,0,57,29,45,201,2,123,2252,26,76,1616,2683,2633,1093
538,2017,Cle Elum-Roslyn,0.095,0.38,0.525,903,436,467,0,5,11,4,82,0,46,754,17,33,373,886,870,530
539,2017,Clover Park,0.22,0.31,0.4766666666666666,13710,6532,7178,0,78,550,1673,4614,653,1912,4227,1680,392,9891,12030,13318,3819
540,2017,Columbia (Walla Walla),0.3,0.33,0.37,779,382,397,0,5,0,6,277,0,20,471,117,16,446,662,763,333
541,2017,Colville,0.18,0.235,0.58,1770,875,895,0,23,9,11,96,2,74,1555,22,39,1005,1748,1731,765
542,2017,Coupeville,0.18,0.35,0.47,1001,539,462,0,1,14,12,138,1,127,708,27,4,381,974,997,620
543,2017,Davenport,0.15,0.54,0.31,622,320,302,0,14,6,2,17,0,12,571,2,7,364,620,615,258
544,2017,Dayton,0.38,0.22,0.41,437,209,228,0,6,7,3,72,0,8,341,2,6,248,435,431,189
545,2017,Deer Park,0.22,0.19,0.59,2558,1244,1314,0,49,13,38,152,2,14,2290,17,491,1245,2541,2067,1313
546,2017,East Valley (Spokane),0.28,0.23,0.5,4407,2117,2290,0,56,45,55,463,37,302,3449,129,178,2566,4278,4229,1841
547,2017,East Valley (Yakima),0.29,0.3,0.41,3254,1566,1688,0,21,30,26,1575,2,84,1516,424,222,1969,2830,3032,1285
548,2017,Eastmont,0.32,0.2,0.48,6303,3087,3216,0,21,47,16,2937,9,183,3090,1155,385,3725,5148,5918,2578
549,2017,Eatonville,0.2,0.28,0.51,1922,935,987,0,13,14,14,141,7,116,1617,9,29,853,1913,1893,1069
550,2017,Edmonds,0.32599999999999996,0.406,0.266,21289,10145,11144,0,108,2743,1425,4420,181,2234,10178,2814,900,8447,18475,20389,12842
551,2017,Ellensburg,0.09,0.47,0.44,3391,1637,1754,0,32,57,37,642,6,75,2542,264,199,1400,3127,3192,1991
552,2017,Elma,0.325,0.065,0.605,1501,732,769,0,15,12,7,312,0,125,1030,135,43,1211,1366,1458,290
553,2017,Enumclaw,0.3,0.3,0.4,4145,1959,2186,0,43,27,22,642,14,176,3221,244,159,1420,3901,3986,2725
554,2017,Ephrata,0.325,0.25,0.435,2605,1252,1353,0,3,13,9,845,1,40,1694,287,166,1545,2318,2439,1060
555,2017,Everett,0.3175,0.345,0.3375,20697,10082,10615,0,99,2933,857,3979,267,1572,10990,2810,1312,7427,17887,19385,13270
556,2017,Evergreen (Clark),0.288,0.258,0.45,25853,12423,13430,0,119,1615,704,5872,486,2156,14901,3634,1641,13399,22219,24212,12454
557,2017,Federal Way,0.242,0.362,0.4,23639,11429,12210,0,125,2709,3362,7062,1259,2881,6241,4879,2186,15274,18760,21453,8365
558,2017,Ferndale,0.335,0.255,0.415,4840,2361,2479,0,420,168,36,925,8,366,2917,321,1044,2436,4519,3796,2404
559,2017,Fife,0.34,0.28,0.38,3836,1872,1964,0,25,312,177,771,195,542,1814,478,146,1719,3358,3690,2117
560,2017,Finley,0.3,0.15,0.55,924,429,495,0,1,2,3,413,0,36,469,166,41,700,758,883,224
561,2017,Franklin Pierce,0.21333333333333335,0.31666666666666665,0.47000000000000003,8065,3954,4111,0,72,488,776,2311,457,1196,2765,809,1413,6545,7256,6652,1520
562,2017,Goldendale,0.26,0.16,0.57,990,464,526,0,50,8,6,136,1,49,740,35,32,587,955,958,403
563,2017,Grand Coulee Dam,0.27,0.2,0.535,750,345,405,0,271,2,2,80,0,165,230,91,39,538,659,711,212
564,2017,Grandview,0.295,0.18,0.52,3813,1881,1932,0,0,3,5,3525,1,11,268,1301,45,3278,2512,3768,535
565,2017,Granger,0.12,0.29,0.59,1381,690,691,0,41,0,1,1284,0,13,42,517,17,1290,864,1364,91
566,2017,Granite Falls,0.28,0.14,0.5800000000000001,2061,1003,1058,0,41,10,24,215,7,116,1648,61,49,1065,2000,2012,996
567,2017,Highland,0.42,0.22,0.36,1185,582,603,0,3,1,3,907,0,16,255,381,90,972,804,1095,213
568,2017,Highline,0.2975,0.27125,0.4325,19969,9557,10412,0,171,2881,2909,7677,784,1211,4336,5599,836,13797,14370,19133,6172
569,2017,Hockinson,0.36,0.38,0.26,1979,964,1015,0,8,49,16,102,2,70,1732,61,226,378,1918,1753,1601
570,2017,Hoquiam,0.485,0.14,0.37,1715,819,896,0,91,13,25,305,1,108,1172,81,42,1227,1634,1673,488
571,2017,Issaquah,0.2,0.645,0.1575,20998,10190,10808,0,32,6042,392,1765,50,1588,11129,1360,914,2034,19638,20084,18964
572,2017,Kalama,0.33,0.32,0.35,1031,461,570,0,10,11,13,79,6,16,896,29,60,378,1002,971,653
573,2017,Kelso,0.27,0.19,0.535,5193,2537,2656,0,58,47,22,897,61,296,3812,332,295,3202,4861,4898,1991
574,2017,Kennewick,0.2675,0.2975,0.4325,18921,9034,9887,0,61,359,455,6721,42,817,10466,2912,477,11244,16009,18444,7677
575,2017,Kent,0.3283333333333333,0.32666666666666666,0.3466666666666667,27876,13437,14439,0,96,5348,3322,6297,731,2688,9394,5681,1855,14814,22195,26021,13062
576,2017,Kettle Falls,0.19,0.32,0.49,1005,516,489,0,20,9,9,70,2,53,842,0,45,520,1005,960,485
577,2017,Kittitas,0.1,0.45,0.45,700,343,357,0,0,7,2,154,1,12,524,42,0,316,658,700,384
578,2017,La Center,0.35,0.23,0.42,1570,748,822,0,5,10,8,104,3,40,1400,33,66,418,1537,1504,1152
579,2017,La Conner,0.38,0.38,0.24,637,307,330,0,228,6,0,59,0,36,308,99,39,392,538,598,245
580,2017,Lake Chelan,0.29500000000000004,0.37,0.33999999999999997,1453,668,785,0,2,10,3,807,0,17,613,414,37,947,1039,1416,506
581,2017,Lake Stevens,0.32,0.31,0.38,9031,4303,4728,0,35,330,167,1282,29,778,6410,388,543,2584,8643,8488,6447
582,2017,Lake Washington,0.16857142857142857,0.6828571428571429,0.15,30316,14656,15660,0,60,8521,542,3158,38,2379,15618,2914,2289,3615,27402,28027,26701
583,2017,Lake Washington Institute of Technology,0.34,0.13,0.52,704,297,407,0,4,37,21,99,5,32,506,0,0,0,704,704,704
584,2017,Lakewood,0.31,0.26,0.43,2493,1190,1303,0,17,41,51,427,44,247,1666,161,102,1011,2332,2391,1482
585,2017,Liberty,0.32,0.39,0.29,516,251,265,0,2,4,2,41,0,18,449,6,23,202,510,493,314
586,2017,Longview,0.3466666666666667,0.22333333333333336,0.43333333333333335,6743,3313,3430,0,94,121,75,1403,41,465,4544,446,415,4399,6297,6328,2344
587,2017,Lynden,0.385,0.23,0.39,3282,1581,1701,0,21,89,43,790,3,140,2196,338,68,1166,2944,3214,2116
588,2017,Mabton,0.27,0.29,0.44,917,462,455,0,3,0,0,897,0,0,17,406,0,866,511,917,51
589,2017,Manson,0.34,0.32,0.34,642,303,339,0,7,1,3,424,0,1,206,242,20,487,400,622,155
590,2017,Marysville,0.31714285714285717,0.2542857142857143,0.42857142857142855,11294,5550,5744,0,682,599,188,2535,95,1233,5962,1506,575,5983,9788,10719,5311
591,2017,Mead,0.2225,0.395,0.3825,10474,5181,5293,0,41,104,139,648,107,846,8589,271,850,3364,10203,9624,7110
592,2017,Medical Lake,0.22999999999999998,0.345,0.42000000000000004,1978,924,1054,0,7,26,58,229,8,168,1482,15,53,781,1963,1925,1197
593,2017,Mercer Island,0.1,0.78,0.12,4553,2103,2450,0,6,951,40,210,5,434,2907,175,795,162,4378,3758,4391
594,2017,Meridian,0.33,0.29,0.38,1804,867,937,0,13,112,14,350,4,107,1204,192,76,756,1612,1728,1048
595,2017,Methow Valley,0.21500000000000002,0.44,0.35,668,318,350,0,7,5,4,39,1,19,592,3,149,304,665,519,364
596,2017,Monroe,0.23,0.4,0.365,7031,3442,3589,0,39,167,83,1527,14,352,4849,633,1111,2158,6398,5920,4873
597,2017,Montesano,0.43,0.25,0.32,1422,682,740,0,25,15,0,150,0,106,1125,26,84,534,1396,1338,888
598,2017,Moses Lake,0.3,0.24,0.45,8701,4326,4375,0,33,85,84,4137,5,209,4148,1430,456,5806,7271,8245,2895
599,2017,Mount Adams,0.11,0.24,0.64,948,451,497,0,517,0,1,343,0,49,38,508,19,812,440,929,136
600,2017,Mount Vernon,0.37,0.26,0.37,7043,3475,3568,0,28,142,61,3774,54,159,2825,1587,341,4530,5456,6702,2513
601,2017,Mukilteo,0.3133333333333333,0.3766666666666667,0.31,15772,7532,8240,0,62,2291,1118,4546,166,1553,6036,3199,731,8237,12573,15041,7535
602,2017,Napavine,0.35,0.18,0.47,846,391,455,0,2,5,4,117,0,41,677,25,47,419,821,799,427
603,2017,Newport,0.225,0.23,0.5449999999999999,1152,514,638,0,11,5,2,59,2,57,1016,2,151,738,1150,1001,414
604,2017,Nine Mile Falls,0.31,0.48,0.21,1431,691,740,0,17,7,11,89,3,90,1214,2,56,433,1429,1375,998
605,2017,Nooksack Valley,0.37,0.22,0.4,1842,881,961,0,71,14,10,620,2,93,1032,260,33,1068,1582,1809,774
606,2017,North Franklin,0.355,0.19,0.45499999999999996,2226,1084,1142,0,1,26,6,1586,0,23,584,762,41,1693,1464,2185,533
607,2017,North Kitsap,0.25,0.41,0.34,6062,2997,3065,0,269,183,57,866,26,689,3972,243,751,2127,5819,5311,3935
608,2017,North Mason,0.265,0.18,0.5549999999999999,2258,1088,1170,0,24,15,9,501,12,149,1548,247,79,1449,2011,2179,809
609,2017,Northshore,0.27999999999999997,0.466,0.256,22884,11107,11777,0,65,4338,450,2886,48,1997,13100,1877,1863,3491,21007,21021,19393
610,2017,Oak Harbor,0.235,0.3,0.47,6015,2876,3139,0,17,398,238,1036,50,696,3580,300,315,2504,5715,5700,3511
611,2017,Ocean Beach,0.16,0.44,0.4,1075,508,567,0,11,9,0,192,1,59,803,52,65,725,1023,1010,350
612,2017,Ocosta,0.14,0.32,0.54,599,281,318,0,21,5,5,121,0,64,381,49,21,463,550,578,136
613,2017,Okanogan,0.32,0.34,0.34,1141,546,595,0,101,4,6,310,0,87,633,145,28,702,996,1113,439
614,2017,Olympia,0.23,0.48666666666666664,0.2833333333333333,10188,4879,5309,0,61,739,242,1159,27,1061,6898,267,194,3218,9921,9994,6970
615,2017,Omak,0.27,0.22999999999999998,0.495,5454,2829,2625,0,443,191,325,752,61,214,3468,206,11,2903,5248,5443,2551
616,2017,Onalaska,0.57,0.17,0.26,893,437,456,0,5,4,0,105,1,43,735,32,17,534,861,876,359
617,2017,Orcas Island,0.18,0.54,0.29,772,398,374,0,5,16,10,86,3,48,604,38,21,242,734,751,530
618,2017,Oroville,0.22,0.25,0.53,621,303,318,0,13,5,1,236,2,10,354,95,22,473,526,599,148
619,2017,Orting,0.19,0.25,0.57,2690,1306,1384,0,14,32,34,377,11,252,1970,37,52,1059,2653,2638,1631
620,2017,Othello,0.225,0.28500000000000003,0.49,4498,2131,2367,0,1,12,6,3929,2,17,414,1834,255,3791,2664,4243,707
621,2017,Pasco,0.37,0.13,0.5,18401,8978,9423,0,21,181,221,13063,28,471,4416,6957,631,13959,11444,17770,4442
622,2017,Peninsula,0.21,0.4766666666666666,0.3133333333333333,9374,4601,4773,0,41,171,88,816,23,874,7361,180,677,2540,9194,8697,6834
623,2017,Port Angeles,0.3,0.26,0.445,3838,1868,1970,0,204,57,28,331,4,410,2804,49,445,2167,3789,3393,1671
624,2017,Port Townsend,0.19,0.37,0.44,1186,611,575,0,13,27,15,96,5,61,969,39,57,628,1147,1129,558
625,2017,Prosser,0.34,0.305,0.36,2753,1376,1377,0,14,35,11,1763,2,73,853,612,66,1940,2141,2687,813
626,2017,Pullman,0.12,0.52,0.36,2938,1413,1525,0,16,284,79,312,6,202,2039,182,146,981,2756,2792,1957
627,2017,Puyallup,0.265,0.355,0.3825,22865,11001,11864,0,223,1182,903,3876,341,2888,13452,1223,1183,8679,21642,21682,14186
628,2017,Quillayute Valley,0.255,0.21,0.535,3009,1672,1337,0,122,45,91,722,17,284,1728,173,61,1834,2836,2948,1175
629,2017,Quincy,0.265,0.265,0.47,2985,1503,1482,0,3,4,11,2636,0,9,322,1321,87,2580,1664,2898,405
630,2017,Rainier,0.33,0.24,0.42,899,444,455,0,8,5,1,87,2,86,710,3,23,465,896,876,434
631,2017,Raymond,0.38,0.3,0.32,655,323,332,0,13,37,4,170,3,25,403,84,21,413,571,634,242
632,2017,Reardan-Edwall,0.19,0.31,0.5,632,306,326,0,19,1,0,21,0,28,563,14,8,259,618,624,373
633,2017,Renton,0.31,0.355,0.3325,16315,7979,8336,0,73,4072,2441,3911,167,1422,4226,2885,1357,8736,13430,14958,7579
634,2017,Richland,0.23,0.4,0.37,14069,6871,7198,0,63,515,263,2548,25,638,10017,708,864,5372,13361,13205,8697
635,2017,Ridgefield,0.32,0.33,0.35,3067,1517,1550,0,12,43,14,352,12,177,2457,111,171,837,2956,2896,2230
636,2017,Ritzville,0.19,0.24,0.57,392,185,207,0,9,6,3,40,0,7,327,1,0,182,391,392,210
637,2017,Riverside,0.19,0.24,0.565,1466,686,780,0,34,11,9,74,3,36,1299,10,43,793,1456,1423,673
638,2017,Riverview,0.2,0.53,0.27,3430,1730,1700,0,13,102,19,426,6,155,2709,155,38,538,3275,3392,2892
639,2017,Rochester,0.34,0.13,0.53,2320,1089,1231,0,76,6,12,494,9,173,1550,221,151,1276,2099,2169,1044
640,2017,Royal,0.38,0.18,0.44,1764,867,897,0,0,1,1,1440,0,2,320,812,60,1325,952,1704,439
641,2017,San Juan Island,0.15000000000000002,0.44,0.415,795,409,386,0,7,10,2,147,0,34,595,44,1,361,751,794,434
642,2017,Sedro-Woolley,0.29000000000000004,0.245,0.45999999999999996,4503,2211,2292,0,97,46,31,928,12,167,3222,323,85,2435,4180,4418,2068
643,2017,Selah,0.3,0.31,0.395,3849,1860,1989,0,22,20,20,1133,4,101,2549,348,212,1971,3501,3637,1878
644,2017,Sequim,0.3,0.29,0.41,2862,1382,1480,0,45,37,12,346,5,224,2193,57,224,1409,2805,2638,1453
645,2017,Shelton,0.24,0.185,0.575,4438,2128,2310,0,143,22,29,1412,12,361,2459,732,127,3134,3706,4311,1304
646,2017,Shoreline,0.27666666666666667,0.5233333333333333,0.19666666666666666,9765,4709,5056,0,31,1293,709,1251,61,1197,5223,728,996,2789,9037,8769,6976
647,2017,Snohomish,0.2966666666666667,0.39666666666666667,0.3066666666666667,10116,4924,5192,0,58,444,92,1140,18,591,7773,401,1056,2122,9715,9060,7994
648,2017,Snoqualmie Valley,0.22,0.58,0.195,7161,3373,3788,0,34,431,47,557,14,415,5663,186,351,813,6975,6810,6348
649,2017,South Bend,0.32,0.13,0.55,686,348,338,0,17,16,4,277,2,66,304,107,1,489,579,685,197
650,2017,South Kitsap,0.28500000000000003,0.21000000000000002,0.505,9814,4740,5074,0,93,283,131,1162,155,1185,6805,267,641,4071,9547,9173,5743
651,2017,South Whidbey,0.255,0.36,0.375,1400,699,701,0,11,30,15,93,3,62,1186,8,69,436,1392,1331,964
652,2017,Spokane,0.24285714285714285,0.34142857142857147,0.4185714285714286,30874,14955,15919,0,380,808,1011,3195,501,4028,20951,2229,1222,18612,28645,29652,12262
653,2017,Stanwood-Camano,0.305,0.27,0.42000000000000004,4603,2233,2370,0,41,61,33,469,17,269,3713,133,152,1396,4470,4451,3207
654,2017,Stevenson-Carson,0.27,0.18,0.55,924,442,482,0,15,4,4,129,1,55,716,26,64,445,898,860,479
655,2017,Sumner,0.24,0.41333333333333333,0.35333333333333333,9923,4859,5064,0,70,194,102,1350,40,908,7259,365,454,3169,9558,9469,6754
656,2017,Sunnyside,0.23,0.19,0.57,6870,3339,3531,0,0,0,8,6349,0,64,449,2240,85,5772,4630,6785,1098
657,2017,Tacoma,0.21625,0.36125,0.42625,30408,14914,15494,0,358,2825,4437,6238,895,3885,11770,3368,1622,19105,27040,28786,11303
658,2017,Tahoma,0.27,0.44,0.29,8558,4096,4462,0,34,396,188,865,81,786,6208,210,328,1246,8348,8230,7312
659,2017,Tenino,0.32,0.11,0.57,1265,593,672,0,7,6,3,108,1,65,1075,19,11,640,1246,1254,625
660,2017,Toledo,0.32999999999999996,0.19,0.48,800,376,424,0,16,5,4,75,1,42,657,13,25,418,787,775,382
661,2017,Tonasket,0.29,0.17,0.54,1181,563,618,0,7,3,2,463,1,45,660,163,3,821,1018,1178,360
662,2017,Toppenish,0.245,0.30000000000000004,0.45499999999999996,4821,2380,2441,0,544,36,32,3502,1,33,673,1717,132,4075,3104,4689,746
663,2017,Tukwila,0.29,0.3,0.4,3059,1488,1571,0,27,883,613,892,104,203,337,1159,134,2414,1900,2925,645
664,2017,Tumwater,0.33,0.3466666666666667,0.3233333333333333,7001,3363,3638,0,38,206,111,860,39,684,5063,167,322,2301,6834,6679,4700
665,2017,University Place,0.26,0.46,0.28,5721,2770,2951,0,24,543,520,839,86,946,2763,310,241,2294,5411,5480,3427
666,2017,Vancouver,0.2414285714285714,0.36428571428571427,0.39285714285714285,23688,11543,12145,0,115,758,587,6286,500,1957,13485,3289,4881,12423,20399,18807,11265
667,2017,Vashon Island,0.2,0.625,0.16999999999999998,1621,751,870,0,3,35,7,200,1,148,1227,79,63,394,1542,1558,1227
668,2017,Wahluke,0.4,0.185,0.41500000000000004,2579,1246,1333,0,15,0,1,2485,1,5,72,1476,14,2528,1103,2565,51
669,2017,Wapato,0.26,0.295,0.445,3426,1596,1830,0,684,63,1,2455,3,113,107,1715,89,3178,1711,3337,248
670,2017,Warden,0.41,0.27,0.32,1009,517,492,0,0,1,5,797,0,12,194,319,27,893,690,982,116
671,2017,Washougal,0.325,0.24,0.435,3245,1560,1685,0,16,39,23,343,5,214,2605,99,120,1268,3146,3125,1977
672,2017,Wenatchee,0.365,0.255,0.375,7882,3745,4137,0,25,70,36,3992,6,178,3575,1910,735,4829,5972,7147,3053
673,2017,West Valley (Spokane),0.27,0.32,0.41,3877,1871,2006,0,25,52,58,336,13,319,3074,107,136,2140,3770,3741,1737
674,2017,West Valley (Yakima),0.3,0.36,0.34,5424,2651,2773,0,51,134,43,1612,11,181,3392,384,467,2290,5040,4957,3134
675,2017,White River,0.19,0.28,0.53,3949,1922,2027,0,29,44,30,425,2,213,3206,107,234,1309,3842,3715,2640
676,2017,White Salmon Valley,0.19,0.4,0.41000000000000003,1331,616,715,0,11,6,2,433,1,34,844,205,100,612,1126,1231,719
677,2017,Winlock,0.44,0.19,0.375,715,332,383,0,5,1,0,174,0,55,480,84,5,550,631,710,165
678,2017,Woodland,0.20500000000000002,0.26,0.54,2501,1182,1319,0,10,14,20,514,2,82,1859,193,295,1238,2308,2206,1263
679,2017,Yakima,0.2425,0.1925,0.5625,16499,8164,8335,0,141,62,119,13009,13,388,2767,5369,665,13339,11130,15834,3160
680,2017,Yelm,0.265,0.255,0.485,5823,2837,2986,0,105,78,74,893,54,656,3963,150,312,2712,5673,5511,3111
681,2017,Zillah,0.43,0.22,0.35,1331,614,717,0,49,3,1,708,0,50,520,174,29,762,1157,1302,569
682,2018,Aberdeen,0.3,0.135,0.5549999999999999,3551,1796,1755,0,97,59,31,1143,5,296,1920,462,93,2571,3089,3458,980
683,2018,Adna,0.37,0.22,0.41,642,331,311,0,5,5,7,39,0,11,575,2,29,190,640,613,452
684,2018,Anacortes,0.25,0.49,0.26,2703,1311,1392,0,29,83,30,266,3,122,2170,56,160,721,2647,2543,1982
685,2018,Arlington,0.245,0.255,0.495,5862,2796,3065,1,58,81,38,819,14,490,4362,295,191,2155,5567,5671,3707
686,2018,Asotin-Anatone,0.13,0.54,0.33,677,340,337,0,2,8,1,38,1,35,592,0,25,246,677,652,431
687,2018,Auburn,0.295,0.33999999999999997,0.365,17612,8551,9061,0,216,1713,1322,5379,776,1733,6473,3442,462,10313,14170,17150,7299
688,2018,Bainbridge Island,0.12,0.685,0.195,3887,1837,2048,2,22,124,19,320,6,335,3061,48,568,294,3839,3319,3593
689,2018,Battle Ground,0.246,0.29,0.466,12956,6298,6656,2,63,316,116,1231,39,675,10516,805,665,4499,12151,12291,8457
690,2018,Bellevue,0.202,0.636,0.16199999999999998,21748,10367,11374,7,52,8854,691,2787,57,1978,7329,3107,2809,4072,18641,18939,17676
691,2018,Bellingham,0.265,0.435,0.295,12068,5781,6277,10,106,653,185,2070,39,952,8063,850,916,4449,11218,11152,7619
692,2018,Bethel,0.2575,0.2425,0.4975,20203,9587,10614,2,182,771,1394,3843,780,2879,10331,1036,982,10853,19167,19221,9350
693,2018,Blaine,0.32,0.25,0.44,2345,1122,1223,0,30,91,33,306,19,161,1705,109,298,1190,2236,2047,1155
694,2018,Bremerton,0.255,0.19,0.56,5028,2460,2568,0,36,180,269,1048,101,810,2584,392,208,3276,4636,4820,1752
695,2018,Brewster,0.325,0.27,0.405,1009,485,524,0,5,1,1,908,0,6,88,455,18,945,554,991,64
696,2018,Burlington-Edison,0.355,0.26,0.39,3558,1679,1879,0,26,56,25,1576,11,130,1733,793,276,1936,2765,3282,1622
697,2018,Camas,0.21999999999999997,0.3866666666666667,0.39999999999999997,7473,3692,3779,2,18,584,66,696,14,660,5435,205,647,1141,7268,6826,6332
698,2018,Cape Flattery,0.31,0.19,0.5,507,253,254,0,250,2,0,96,0,103,56,0,0,377,507,507,130
699,2018,Cascade,0.3,0.36,0.34,1357,663,692,2,8,3,6,400,1,40,894,175,25,616,1182,1332,741
700,2018,Castle Rock,0.26,0.16,0.59,1445,701,744,0,12,9,3,113,4,89,1215,32,23,802,1413,1422,643
701,2018,Central Kitsap,0.3775,0.3125,0.3125,11501,5533,5968,0,42,497,374,1737,128,2027,6696,297,626,4285,11204,10875,7216
702,2018,Central Valley,0.22999999999999998,0.38000000000000006,0.3833333333333333,14592,6958,7632,2,220,285,338,164,162,686,12736,460,1463,5969,14132,13129,8623
703,2018,Centralia,0.445,0.13,0.42000000000000004,3541,1725,1816,0,22,25,39,1293,4,149,2008,425,140,2749,3116,3401,792
704,2018,Chehalis,0.4,0.235,0.365,3146,1458,1688,0,11,33,51,624,10,212,2205,167,83,1579,2979,3063,1567
705,2018,Cheney,0.20500000000000002,0.35,0.445,5158,2434,2724,0,101,87,74,585,65,376,3870,186,398,2634,4972,4760,2524
706,2018,Chewelah,0.29,0.18000000000000002,0.53,775,368,404,3,5,2,1,31,0,53,683,0,32,451,775,743,324
707,2018,Chimacum,0.22,0.21,0.575,873,411,462,0,7,12,4,72,1,67,710,13,53,469,860,820,404
708,2018,Clarkston,0.195,0.28,0.53,2672,1323,1349,0,50,29,40,207,1,127,2218,30,74,1568,2642,2598,1104
709,2018,Cle Elum-Roslyn,0.11,0.4,0.485,874,433,439,2,7,11,3,77,0,47,729,19,31,375,855,843,499
710,2018,Clover Park,0.22666666666666668,0.24666666666666667,0.5233333333333333,13584,6537,7045,2,69,509,1663,4630,699,1922,4082,1872,299,10195,11712,13285,3389
711,2018,Colfax,0.17,0.53,0.29,552,251,301,0,1,5,0,16,0,47,483,1,13,191,551,539,361
712,2018,College Place,0.4,0.22,0.38,1468,709,759,0,3,8,8,625,7,73,743,268,93,858,1200,1375,610
713,2018,Columbia (Walla Walla),0.32,0.26,0.42,767,370,397,0,4,2,8,297,0,16,440,131,18,434,636,749,333
714,2018,Colville,0.12,0.4,0.475,1838,910,928,0,25,10,11,108,0,84,1600,30,39,1016,1808,1799,822
715,2018,Coupeville,0.13,0.35,0.52,998,521,476,1,3,9,10,148,2,120,706,32,13,384,966,985,614
716,2018,Darrington,0.32,0.27,0.41,453,236,216,1,16,4,4,27,0,36,366,3,5,241,450,448,212
717,2018,Davenport,0.13,0.4,0.46,591,303,288,0,11,5,1,17,0,17,540,2,3,344,589,588,247
718,2018,Dayton,0.38,0.33,0.29,414,203,211,0,5,5,4,74,0,5,321,2,1,234,412,413,180
719,2018,Deer Park,0.17,0.19,0.64,2638,1278,1358,2,68,14,33,145,2,15,2361,23,183,1328,2615,2455,1310
720,2018,East Valley (Spokane),0.25,0.24,0.51,4229,2045,2184,0,52,44,57,461,24,287,3304,111,186,2490,4118,4043,1739
721,2018,East Valley (Yakima),0.32,0.22,0.47,3249,1555,1694,0,21,25,20,1633,3,92,1455,395,212,1983,2854,3037,1266
722,2018,Eastmont,0.39,0.2,0.415,6342,3104,3237,1,22,45,19,2983,7,187,3079,1097,368,3736,5245,5974,2606
723,2018,Eatonville,0.21,0.28,0.51,1975,972,1002,1,15,9,16,165,8,127,1635,6,21,889,1969,1954,1086
724,2018,Edmonds,0.324,0.384,0.294,21364,10155,11199,10,92,2725,1493,4511,193,2233,10117,2934,860,8477,18430,20504,12887
725,2018,Ellensburg,0.1,0.42,0.48,3355,1635,1718,2,30,62,38,609,6,93,2517,261,222,1387,3094,3133,1968
726,2018,Elma,0.3,0.18,0.515,1533,757,776,0,23,11,6,326,0,128,1039,123,100,1202,1410,1433,331
727,2018,Enumclaw,0.22,0.31,0.46,4155,1978,2176,1,49,22,28,677,9,173,3197,261,209,1386,3894,3946,2769
728,2018,Ephrata,0.25,0.235,0.515,2634,1263,1371,0,3,16,9,875,1,48,1682,292,177,1542,2342,2457,1092
729,2018,Everett,0.31,0.34750000000000003,0.34249999999999997,20943,10148,10766,29,95,3204,878,4194,261,1820,10490,2933,1538,8220,18010,19405,12723
730,2018,Evergreen (Clark),0.27999999999999997,0.262,0.45600000000000007,25233,12132,13090,11,115,1554,687,6145,494,2155,14083,3611,1692,13192,21622,23541,12041
731,2018,Federal Way,0.27,0.33999999999999997,0.394,23562,11464,12075,23,119,2752,3590,7310,1275,2643,5873,5117,2182,15605,18445,21380,7957
732,2018,Ferndale,0.31,0.3,0.385,4823,2327,2494,2,391,173,41,972,10,382,2854,358,1026,2451,4465,3797,2372
733,2018,Fife,0.31,0.31,0.38,3835,1853,1981,1,27,305,207,797,227,528,1744,500,155,1857,3335,3680,1978
734,2018,Finley,0.3,0.11,0.59,908,424,484,0,2,2,6,426,0,31,441,172,55,694,736,853,214
735,2018,Franklin Pierce,0.20333333333333334,0.3133333333333333,0.48333333333333334,8055,3914,4141,0,69,498,797,2360,469,1224,2638,836,792,6442,7219,7263,1613
736,2018,Goldendale,0.34,0.24,0.41,980,450,530,0,48,6,3,134,1,56,732,31,39,597,949,941,383
737,2018,Grand Coulee Dam,0.26,0.24,0.5,770,366,404,0,289,2,2,86,0,166,225,90,26,568,680,744,202
738,2018,Grandview,0.27,0.225,0.5,3746,1816,1930,0,2,3,4,3467,3,9,258,1200,57,3193,2546,3689,553
739,2018,Granger,0.24,0.29,0.47,1559,786,773,0,49,0,5,1438,0,0,67,597,14,1406,962,1545,153
740,2018,Granite Falls,0.26,0.2,0.53,2098,1017,1081,0,37,14,21,252,8,129,1637,63,44,1035,2035,2054,1063
741,2018,Highland,0.23,0.29,0.48,1200,589,611,0,2,2,4,916,0,13,263,375,50,989,825,1150,211
742,2018,Highline,0.26,0.308,0.43200000000000005,19285,9222,10062,1,141,2823,2819,7567,756,1186,3992,5552,801,13313,13733,18484,5972
743,2018,Hockinson,0.24,0.34,0.42,1991,986,1005,0,8,45,15,120,2,85,1716,56,217,408,1935,1774,1583
744,2018,Hoquiam,0.345,0.165,0.49,1719,820,899,0,87,12,19,308,1,131,1161,71,85,1333,1648,1634,386
745,2018,Issaquah,0.165,0.6725,0.1625,20961,10163,10798,0,31,6261,406,1794,43,1655,10771,1362,1026,1935,19599,19935,19026
746,2018,Kalama,0.32,0.27,0.41,1044,469,575,0,11,8,18,91,7,18,891,33,72,409,1011,972,635
747,2018,Kelso,0.245,0.225,0.525,5160,2483,2677,0,60,55,16,915,76,343,3695,339,328,3136,4821,4832,2024
748,2018,Kennewick,0.2775,0.265,0.45999999999999996,19705,9521,10179,5,57,371,1146,6844,45,887,10355,2501,448,11366,17204,19257,8339
749,2018,Kent,0.31,0.33666666666666667,0.35166666666666674,27215,13132,14083,0,89,5384,3395,6121,674,2595,8957,5658,2133,14511,21557,25082,12704
750,2018,Kittitas,0.16,0.55,0.3,701,340,361,0,0,5,3,160,0,5,528,60,0,321,641,701,380
751,2018,La Center,0.33,0.27,0.4,1722,828,892,2,7,8,8,116,3,48,1532,34,118,426,1688,1604,1296
752,2018,La Conner,0.25,0.44,0.31,664,322,342,0,226,6,0,81,0,44,307,120,40,401,544,624,263
753,2018,Lake Chelan,0.19,0.345,0.46499999999999997,1449,659,789,1,0,8,4,804,1,15,617,394,52,965,1055,1397,484
754,2018,Lake Stevens,0.29,0.31,0.4,9295,4452,4842,1,36,351,171,1349,35,807,6546,433,654,2624,8862,8641,6671
755,2018,Lake Washington,0.15,0.6733333333333333,0.17666666666666667,31264,14991,16272,1,52,9423,585,3317,38,2601,15248,3112,2593,3505,28152,28671,27759
756,2018,Lake Washington Institute of Technology,0.35,0.16,0.49,778,345,433,0,7,47,37,118,6,33,530,0,0,0,778,778,778
757,2018,Lakewood,0.23,0.18,0.59,2535,1230,1305,0,19,43,55,416,36,323,1643,162,116,1068,2373,2419,1467
758,2018,Liberty,0.21,0.48,0.3,533,261,272,0,1,4,3,39,0,22,464,6,27,190,527,506,343
759,2018,Longview,0.25,0.25,0.5,6752,3341,3411,0,102,131,68,1414,54,466,4517,446,392,4427,6306,6360,2325
760,2018,Lynden,0.395,0.28500000000000003,0.32,3481,1702,1779,0,17,95,37,831,6,166,2329,368,71,1218,3113,3410,2263
761,2018,Mabton,0.21,0.13,0.66,843,411,432,0,2,0,0,824,0,0,17,365,0,805,478,843,38
762,2018,Marysville,0.32666666666666666,0.21999999999999997,0.4533333333333333,11200,5504,5696,0,624,672,206,2634,102,1225,5737,1465,480,5912,9735,10720,5288
763,2018,Mead,0.195,0.39,0.4175,10788,5295,5493,0,58,122,133,716,112,854,8793,299,982,3441,10489,9806,7347
764,2018,Medical Lake,0.20500000000000002,0.325,0.475,2002,917,1085,0,8,22,56,223,7,156,1530,8,48,800,1994,1954,1202
765,2018,Mercer Island,0.1,0.76,0.14,4522,2090,2428,4,4,1002,43,217,5,473,2778,177,734,190,4345,3788,4332
766,2018,Meridian,0.35,0.33,0.33,1772,863,909,0,18,103,17,338,4,112,1180,181,93,707,1591,1679,1065
767,2018,Methow Valley,0.155,0.515,0.33,723,336,385,2,5,5,3,51,1,19,639,4,192,313,719,531,410
768,2018,Monroe,0.305,0.31,0.385,6924,3396,3526,2,31,149,90,1524,16,378,4735,631,153,2140,6293,6771,4784
769,2018,Montesano,0.49,0.2,0.31,1439,694,745,0,27,13,0,160,1,121,1117,24,110,554,1415,1329,885
770,2018,Moses Lake,0.31,0.24,0.45,8857,4360,4497,0,28,84,80,4297,6,224,4138,1386,203,5862,7471,8654,2995
771,2018,Mount Adams,0.14,0.27,0.59,918,438,480,0,485,0,3,332,0,56,42,455,24,881,463,894,37
772,2018,Mount Vernon,0.335,0.28500000000000003,0.39,7045,3467,3578,0,32,138,57,3834,56,154,2774,1615,349,4551,5430,6696,2494
773,2018,Mukilteo,0.3133333333333333,0.36000000000000004,0.3233333333333333,16013,7663,8350,0,68,2314,1249,4528,157,1669,6028,3310,1021,8546,12703,14992,7467
774,2018,Napavine,0.44,0.1,0.46,830,371,459,0,2,5,4,123,1,47,648,25,60,404,805,770,426
775,2018,Newport,0.21000000000000002,0.32999999999999996,0.46499999999999997,1154,531,623,0,16,4,4,57,1,58,1011,1,152,758,1153,1002,396
776,2018,Nine Mile Falls,0.21,0.31,0.48,1415,656,759,0,13,8,13,87,3,79,1212,2,66,396,1413,1349,1019
777,2018,Nooksack Valley,0.35,0.32,0.34,1905,922,983,0,69,16,7,650,3,89,1071,261,19,1096,1644,1886,809
778,2018,North Franklin,0.315,0.22999999999999998,0.45499999999999996,2210,1059,1150,1,1,24,11,1580,0,26,568,778,49,1678,1432,2161,532
779,2018,North Kitsap,0.26333333333333336,0.3633333333333333,0.36999999999999994,6054,3010,3042,2,287,189,54,895,29,718,3882,236,719,2128,5818,5335,3926
780,2018,North Mason,0.32,0.16999999999999998,0.505,2333,1100,1233,0,33,15,11,554,7,149,1564,271,80,1490,2062,2253,843
781,2018,Northshore,0.254,0.47000000000000003,0.27599999999999997,23572,11510,12047,15,60,4774,491,2920,39,2071,13217,1814,2646,3548,21758,20926,20024
782,2018,Oak Harbor,0.22,0.305,0.475,6081,2938,3142,1,22,374,247,1085,46,705,3602,299,392,2570,5782,5689,3511
783,2018,Ocean Beach,0.25,0.3,0.45,1081,522,559,0,10,9,2,188,1,62,809,52,66,727,1029,1015,354
784,2018,Ocosta,0.31,0.12,0.57,635,301,334,0,21,1,6,139,0,77,391,51,9,538,584,626,97
785,2018,Okanogan,0.29,0.39,0.32,1146,535,611,0,90,4,8,317,0,101,626,129,30,746,1017,1116,400
786,2018,Olympia,0.19666666666666666,0.48666666666666664,0.32,10238,4857,5374,7,54,753,264,1210,44,1114,6799,311,308,3266,9927,9930,6972
787,2018,Omak,0.20500000000000002,0.33999999999999997,0.45499999999999996,5543,2815,2725,3,404,205,330,836,50,245,3473,223,62,2811,5320,5481,2732
788,2018,Onalaska,0.36,0.13,0.51,875,427,448,0,4,3,0,93,1,48,726,35,21,538,840,854,337
789,2018,Oroville,0.24,0.24,0.52,571,272,299,0,11,3,4,226,1,7,319,83,16,448,488,555,123
790,2018,Orting,0.17,0.29,0.54,2752,1336,1416,0,17,39,42,405,8,265,1976,63,70,949,2689,2682,1803
791,2018,Othello,0.35,0.20500000000000002,0.445,4668,2224,2444,0,3,15,6,4181,2,17,427,1860,202,3912,2808,4466,756
792,2018,Pasco,0.305,0.16499999999999998,0.53,18774,9179,9595,0,23,207,177,13276,32,486,4573,6603,765,13748,12171,18009,5026
793,2018,Peninsula,0.20666666666666667,0.47333333333333333,0.32,9478,4677,4801,0,34,161,67,916,21,1048,7231,170,739,2145,9308,8739,7333
794,2018,Port Angeles,0.295,0.28,0.425,3846,1833,2012,1,200,60,25,348,5,396,2812,54,445,2107,3792,3401,1739
795,2018,Port Townsend,0.22,0.28,0.5,1230,605,622,3,16,26,14,93,3,68,1010,37,72,672,1193,1158,558
796,2018,Prosser,0.34,0.24,0.42,2724,1343,1381,0,14,32,11,1755,3,77,832,589,74,1936,2135,2650,788
797,2018,Pullman,0.15,0.6,0.25,2913,1402,1511,0,18,271,87,326,5,203,2003,186,131,977,2727,2782,1936
798,2018,Puyallup,0.225,0.38,0.395,23157,11151,12006,0,229,1292,1046,3927,386,2955,13322,1330,1305,8979,21827,21852,14178
799,2018,Quillayute Valley,0.245,0.11499999999999999,0.645,3291,1828,1463,0,99,62,89,782,17,320,1922,194,50,1885,3097,3241,1406
800,2018,Quincy,0.3,0.2,0.495,3023,1539,1484,0,2,6,11,2674,0,10,320,1317,90,2587,1706,2933,436
801,2018,Rainier,0.24,0.15,0.61,905,439,465,1,3,5,3,88,2,93,711,3,21,433,902,884,472
802,2018,Raymond,0.37,0.29,0.34,585,282,301,2,14,34,3,172,3,13,346,71,20,380,514,565,205
803,2018,Reardan-Edwall,0.2,0.35,0.45,625,306,318,1,21,1,1,22,0,30,550,11,5,256,614,620,369
804,2018,Renton,0.355,0.34,0.3075,16334,8036,8292,6,73,4074,2340,4043,182,1500,4122,2858,1283,8538,13476,15051,7796
805,2018,Richland,0.23,0.38,0.39,14186,6931,7255,0,68,492,223,2663,24,659,10057,729,926,5750,13457,13260,8436
806,2018,Ridgefield,0.31,0.23,0.46,3230,1604,1626,0,16,41,19,393,5,184,2572,101,202,829,3129,3028,2401
807,2018,Ritzville,0.15,0.35,0.5,384,182,202,0,6,7,2,45,1,9,314,0,0,191,384,384,193
808,2018,Riverside,0.245,0.32,0.44,1454,678,775,1,28,13,8,81,2,42,1280,10,51,793,1444,1403,661
809,2018,Riverview,0.21,0.51,0.275,3470,1716,1748,6,12,109,27,438,4,161,2719,173,36,502,3297,3434,2968
810,2018,Rochester,0.33999999999999997,0.155,0.51,2359,1108,1251,0,82,11,9,518,12,191,1536,220,157,1268,2139,2202,1091
811,2018,Royal,0.4,0.14,0.46,1755,868,887,0,0,2,0,1426,0,6,321,794,102,1376,961,1653,379
812,2018,San Juan Island,0.15,0.365,0.485,805,413,392,0,5,10,3,153,0,30,604,46,3,341,759,802,464
813,2018,Sedro-Woolley,0.275,0.21000000000000002,0.515,4690,2298,2392,0,106,43,23,1007,14,208,3288,389,94,2558,4301,4596,2132
814,2018,Selah,0.27,0.265,0.46499999999999997,3857,1887,1969,1,15,25,17,1168,3,102,2527,342,289,2073,3515,3568,1784
815,2018,Sequim,0.31,0.3,0.39,2828,1386,1442,0,42,45,17,346,7,222,2149,60,242,1375,2768,2586,1453
816,2018,Shelton,0.255,0.175,0.5700000000000001,4468,2118,2346,4,139,19,21,1510,15,355,2409,827,112,3117,3641,4356,1351
817,2018,Shoreline,0.2866666666666667,0.54,0.17,9819,4717,5100,2,26,1276,765,1314,56,1235,5147,787,1118,2847,9032,8701,6972
818,2018,Snohomish,0.29,0.4366666666666667,0.27999999999999997,10037,4848,5184,5,46,480,102,1157,19,622,7611,410,1813,2052,9627,8224,7985
819,2018,Snoqualmie Valley,0.2,0.585,0.22,7240,3444,3796,0,35,480,65,599,18,455,5588,226,383,805,7014,6857,6435
820,2018,South Bend,0.53,0.18,0.29,652,323,329,0,16,24,3,280,1,61,267,107,1,441,545,651,211
821,2018,South Kitsap,0.22,0.25,0.53,9795,4729,5066,0,92,263,138,1232,165,1194,6711,284,696,3940,9511,9099,5855
822,2018,South Whidbey,0.14500000000000002,0.43,0.42,1361,683,678,0,9,21,12,107,2,98,1112,10,57,435,1351,1304,926
823,2018,Spokane,0.22142857142857145,0.33714285714285713,0.4428571428571429,31061,15045,16015,1,333,739,977,3353,517,4264,20859,2180,1131,18701,28881,29930,12360
824,2018,Stanwood-Camano,0.235,0.32999999999999996,0.435,4703,2272,2431,0,41,63,37,499,17,294,3752,149,150,1421,4554,4553,3282
825,2018,Stevenson-Carson,0.22,0.19,0.58,953,469,484,0,16,5,3,135,1,51,740,32,72,509,921,881,444
826,2018,Sumner,0.20666666666666667,0.3833333333333333,0.41,10100,4928,5172,0,66,210,100,1427,51,998,7248,390,531,3086,9710,9569,7014
827,2018,Sunnyside,0.22,0.21,0.58,6846,3370,3476,0,2,3,7,6336,0,56,442,2164,156,5911,4682,6690,935
828,2018,Tacoma,0.23,0.3575,0.41125,30323,14814,15501,8,325,2719,4125,6370,945,4451,11388,3295,1678,18631,27028,28645,11692
829,2018,Tahoma,0.3,0.41,0.29,8846,4233,4609,4,32,469,207,906,83,868,6281,250,406,1337,8596,8440,7509
830,2018,Tenino,0.31,0.17,0.52,1304,600,704,0,11,7,8,114,1,72,1091,18,9,660,1286,1295,644
831,2018,Toledo,0.29500000000000004,0.175,0.53,810,381,428,1,15,6,9,76,1,32,671,10,24,455,800,786,355
832,2018,Tonasket,0.11,0.3,0.59,1181,569,612,0,10,2,3,462,1,55,635,164,6,858,1017,1175,323
833,2018,Toppenish,0.28500000000000003,0.21500000000000002,0.5,4630,2284,2346,0,508,31,28,3433,1,45,584,1722,126,3875,2908,4504,755
834,2018,Tukwila,0.25,0.38,0.37,3043,1488,1553,2,27,830,620,875,113,196,382,1027,113,2305,2016,2930,738
835,2018,Tumwater,0.31666666666666665,0.3433333333333333,0.3433333333333333,6820,3289,3529,2,34,182,118,864,31,667,4924,139,306,2254,6681,6514,4566
836,2018,University Place,0.28,0.44,0.27,5826,2858,2968,0,28,572,544,894,94,982,2712,329,239,2292,5497,5587,3534
837,2018,Vancouver,0.24714285714285714,0.3528571428571428,0.3971428571428572,23567,11516,12051,0,108,729,612,6387,531,2015,13185,3291,4587,12290,20276,18980,11277
838,2018,Vashon Island,0.15,0.56,0.29000000000000004,1591,743,848,0,2,33,5,202,1,138,1210,78,62,389,1513,1529,1202
839,2018,Wahluke,0.33499999999999996,0.14500000000000002,0.515,2547,1223,1324,0,12,0,2,2471,1,5,56,1367,22,2340,1180,2525,207
840,2018,Wapato,0.265,0.245,0.5,3456,1622,1834,0,711,69,0,2478,2,106,90,1774,138,3196,1682,3318,260
841,2018,Warden,0.43,0.2,0.37,972,486,485,1,0,1,5,762,0,10,194,295,31,863,677,941,109
842,2018,Washougal,0.23,0.3,0.47,3222,1552,1670,0,14,36,20,348,3,223,2578,85,137,1247,3137,3085,1975
843,2018,Wenatchee,0.345,0.31,0.345,7884,3766,4117,1,22,81,37,4034,4,167,3539,1929,789,4827,5955,7095,3057
844,2018,West Valley (Spokane),0.26,0.42,0.33,3788,1661,1871,256,21,50,57,378,16,326,2940,119,148,2146,3669,3640,1642
845,2018,West Valley (Yakima),0.27,0.4,0.33,5523,2688,2834,1,47,136,46,1732,12,180,3370,410,509,2556,5113,5014,2967
846,2018,White River,0.19,0.28,0.52,4104,1990,2114,0,30,55,34,456,7,218,3304,145,268,1263,3959,3836,2841
847,2018,White Salmon Valley,0.165,0.33499999999999996,0.505,1280,602,678,0,10,8,1,411,2,40,808,205,95,597,1075,1185,683
848,2018,Winlock,0.35,0.165,0.485,765,362,403,0,3,5,0,181,0,58,518,82,16,710,683,749,55
849,2018,Woodland,0.25,0.21000000000000002,0.54,2536,1200,1336,0,9,19,20,536,2,92,1858,202,263,1262,2334,2273,1274
850,2018,Yakima,0.2833333333333334,0.22333333333333336,0.49666666666666665,16406,8116,8290,0,153,67,88,13038,11,387,2662,5104,550,13462,11302,15856,2944
851,2018,Yelm,0.195,0.265,0.54,5862,2854,3008,0,95,83,72,920,69,658,3965,160,338,2713,5702,5524,3149
852,2018,Zillah,0.32,0.29,0.39,1346,616,730,0,44,6,0,727,0,51,518,157,43,795,1189,1303,551
853,2019,Aberdeen,0.29000000000000004,0.16,0.55,3546,1801,1745,0,86,51,34,1159,4,296,1896,458,90,2665,3088,3456,881
854,2019,Adna,0.42,0.18,0.4,642,323,316,3,6,4,6,49,0,13,564,3,27,194,639,615,448
855,2019,Anacortes,0.23,0.41500000000000004,0.355,2624,1280,1344,0,21,70,24,267,2,143,2097,51,220,684,2573,2404,1940
856,2019,Arlington,0.265,0.255,0.48,5962,2890,3067,5,51,88,35,814,17,498,4459,301,203,2241,5661,5759,3721
857,2019,Asotin-Anatone,0.22,0.41,0.37,625,314,311,0,2,7,1,38,2,36,539,0,32,237,625,593,388
858,2019,Auburn,0.28500000000000003,0.2875,0.43,17999,8713,9286,0,208,1849,1407,5486,824,1812,6413,3818,593,10567,14181,17406,7432
859,2019,Bainbridge Island,0.08499999999999999,0.71,0.21000000000000002,3888,1869,2017,2,16,119,24,323,5,354,3022,53,535,315,3835,3353,3573
860,2019,Battle Ground,0.27,0.23399999999999999,0.496,12812,6308,6503,1,58,316,135,1362,60,699,10182,852,659,4474,11960,12153,8338
861,2019,Bellevue,0.16833333333333333,0.6566666666666666,0.17500000000000002,21764,10444,11308,12,39,9078,689,2839,59,2022,7038,3091,3242,3891,18673,18522,17873
862,2019,Bellingham,0.28500000000000003,0.4225,0.2925,12052,5725,6304,23,107,640,177,2043,39,1047,7999,882,895,4430,11170,11157,7622
863,2019,Bethel,0.25,0.178,0.5700000000000001,20785,9960,10819,6,205,792,1413,4244,890,3073,10168,1136,1038,11121,19649,19747,9664
864,2019,Blaine,0.3,0.2,0.5,2326,1141,1185,0,33,91,39,330,17,160,1656,100,310,1188,2226,2016,1138
865,2019,Bremerton,0.305,0.18,0.515,4944,2424,2520,0,31,177,282,1104,97,800,2453,459,217,3304,4485,4727,1640
866,2019,Brewster,0.31,0.26,0.43,926,444,482,0,5,2,0,821,0,7,91,386,18,840,540,908,86
867,2019,Burlington-Edison,0.275,0.29000000000000004,0.435,3577,1689,1887,1,26,47,22,1611,8,160,1703,768,240,1942,2809,3337,1635
868,2019,Camas,0.21,0.53,0.255,7647,3750,3894,3,22,606,71,785,17,691,5455,212,742,1173,7435,6905,6474
869,2019,Cape Flattery,0.26,0.23,0.52,520,252,268,0,252,1,0,101,0,108,58,0,2,418,520,518,102
870,2019,Cascade,0.26,0.39,0.35,1371,669,700,2,8,7,9,427,0,48,872,177,26,680,1194,1345,691
871,2019,Castle Rock,0.33,0.09,0.58,1505,712,793,0,11,9,2,121,4,89,1269,27,22,816,1478,1483,689
872,2019,Central Kitsap,0.3175,0.355,0.3325,11919,5782,6136,1,48,515,384,1883,146,2056,6886,315,1189,1932,11604,10730,9987
873,2019,Central Valley,0.22,0.3833333333333333,0.3866666666666667,14818,7013,7802,3,200,282,367,411,152,764,12636,481,930,5568,14337,13888,9250
874,2019,Centralia,0.41000000000000003,0.14500000000000002,0.445,3586,1736,1843,7,17,28,35,1326,6,164,2007,436,109,2891,3150,3477,695
875,2019,Chehalis,0.385,0.28500000000000003,0.325,3269,1543,1725,1,17,35,52,637,7,202,2319,149,95,1565,3120,3174,1704
876,2019,Cheney,0.15,0.365,0.48,5241,2474,2764,3,110,85,94,584,91,393,3884,223,324,2677,5018,4917,2564
877,2019,Chewelah,0.22,0.3233333333333333,0.4566666666666667,735,367,363,5,8,4,2,41,0,62,618,0,30,437,735,705,298
878,2019,Chimacum,0.19,0.25,0.56,826,389,436,1,5,8,3,73,2,67,668,10,43,446,816,783,380
879,2019,Clarkston,0.125,0.345,0.53,2707,1343,1364,0,56,23,27,220,0,153,2228,20,69,1595,2687,2638,1112
880,2019,Cle Elum-Roslyn,0.16,0.38,0.46499999999999997,918,459,457,2,8,7,2,87,0,54,760,15,29,408,903,889,510
881,2019,Clover Park,0.26,0.26333333333333336,0.4766666666666666,13763,6607,7140,16,78,506,1627,4687,777,2004,4084,1762,284,10088,12001,13479,3675
882,2019,Colfax,0.24,0.37,0.39,558,255,301,2,2,4,0,21,0,45,486,1,20,186,557,538,372
883,2019,College Place,0.51,0.19,0.31,1629,777,851,1,8,8,8,704,6,88,807,288,102,936,1341,1527,693
884,2019,Columbia (Walla Walla),0.49,0.2,0.31,788,376,412,0,6,2,9,309,0,18,444,127,59,447,661,729,341
885,2019,Colville,0.20500000000000002,0.31,0.485,1745,868,875,2,24,8,8,100,0,103,1502,16,41,958,1729,1704,787
886,2019,Coupeville,0.22,0.28,0.51,1037,557,479,1,2,11,12,153,2,132,725,33,28,385,1004,1009,652
887,2019,Darrington,0.15,0.27,0.58,453,234,218,1,17,3,3,33,0,32,365,6,4,244,447,449,209
888,2019,Davenport,0.16,0.24,0.6,593,286,307,0,8,8,3,17,0,27,530,2,4,310,591,589,283
889,2019,Dayton,0.48,0.26,0.26,430,210,220,0,6,6,2,77,0,10,329,2,8,243,428,422,187
890,2019,Deer Park,0.17,0.2,0.63,2651,1287,1363,1,68,15,33,152,5,9,2369,18,479,1352,2633,2172,1299
891,2019,East Valley (Spokane),0.23,0.3,0.46,4078,1971,2102,5,48,48,48,432,36,280,3186,145,107,2417,3933,3971,1661
892,2019,East Valley (Yakima),0.3,0.21,0.49,3284,1577,1705,2,21,24,23,1673,4,103,1436,379,191,2003,2905,3093,1281
893,2019,Eastmont,0.34,0.12,0.54,6336,3084,3251,1,21,45,21,3052,4,183,3010,1078,321,3683,5258,6015,2653
894,2019,Eatonville,0.27,0.22,0.5,2047,982,1062,3,12,15,9,186,5,130,1675,13,20,890,2034,2027,1157
895,2019,Edmonds,0.31,0.38,0.312,21697,10240,11437,20,106,2792,1559,4723,190,2319,10008,3109,861,8445,18588,20836,13252
896,2019,Ellensburg,0.125,0.385,0.495,3436,1657,1775,4,33,62,38,670,5,117,2511,268,207,1473,3168,3229,1963
897,2019,Elma,0.32,0.15500000000000003,0.525,1606,783,823,0,20,11,10,341,0,128,1096,126,87,1172,1480,1519,434
898,2019,Enumclaw,0.23,0.3,0.48,4300,2058,2241,1,48,28,33,728,11,190,3262,268,227,1450,4032,4073,2850
899,2019,Ephrata,0.28,0.17,0.55,2673,1278,1395,0,7,17,12,925,1,61,1650,299,221,1464,2374,2452,1209
900,2019,Everett,0.31,0.32,0.365,21198,10292,10884,22,95,3431,915,4324,271,1746,10416,3081,1696,8529,18117,19502,12669
901,2019,Evergreen (Clark),0.248,0.27199999999999996,0.47800000000000004,25380,12106,13251,23,113,1533,691,6405,529,2246,13863,3680,1925,13294,21700,23455,12086
902,2019,Federal Way,0.272,0.312,0.41600000000000004,23319,11372,11940,7,118,2714,3546,7425,1289,2699,5528,5244,2270,15716,18075,21049,7603
903,2019,Ferndale,0.275,0.32,0.405,4819,2321,2494,4,385,172,46,1010,8,409,2788,361,973,2379,4458,3846,2440
904,2019,Fife,0.27,0.34,0.39,3901,1892,2008,1,32,324,198,826,251,566,1704,530,144,1900,3371,3757,2001
905,2019,Finley,0.33,0.1,0.57,915,429,486,0,4,2,5,438,0,36,430,170,49,712,745,866,203
906,2019,Franklin Pierce,0.21666666666666667,0.2933333333333334,0.48666666666666664,8061,3884,4176,1,75,497,783,2453,479,1280,2494,886,525,6480,7175,7536,1581
907,2019,Goldendale,0.21,0.24,0.56,945,444,501,0,47,5,2,129,1,59,702,36,17,596,909,928,349
908,2019,Grand Coulee Dam,0.22,0.19,0.5900000000000001,759,362,397,0,270,3,2,92,0,165,227,139,32,566,620,727,193
909,2019,Grandview,0.255,0.245,0.5,3750,1817,1933,0,7,2,3,3478,0,12,248,1209,56,3180,2541,3694,570
910,2019,Granger,0.25,0.21,0.54,1579,794,785,0,50,0,2,1465,0,0,62,606,12,1380,973,1567,199
911,2019,Granite Falls,0.28500000000000003,0.14500000000000002,0.565,2165,1049,1116,0,46,20,24,258,8,136,1673,74,37,1013,2091,2128,1152
912,2019,Highland,0.32,0.17,0.51,1179,561,610,8,2,3,2,910,0,14,248,347,44,972,832,1135,207
913,2019,Highline,0.292,0.29,0.41200000000000003,19514,9243,10242,29,131,2866,2899,7745,725,1293,3855,5569,756,13855,13945,18758,5659
914,2019,Hockinson,0.22,0.49,0.3,2034,1008,1026,0,9,52,16,123,5,105,1724,68,215,416,1966,1819,1618
915,2019,Hoquiam,0.42,0.195,0.385,1621,773,844,4,83,15,19,318,1,124,1061,85,71,1239,1536,1550,382
916,2019,Issaquah,0.17,0.6725,0.1575,21455,10491,10964,0,41,6630,423,1902,48,1748,10663,1427,1076,2040,20028,20379,19415
917,2019,Kalama,0.25,0.19,0.56,1079,495,583,1,14,8,14,111,7,17,908,45,74,393,1034,1005,686
918,2019,Kelso,0.275,0.175,0.545,5034,2398,2631,5,56,59,22,874,74,335,3614,339,338,3091,4695,4696,1943
919,2019,Kennewick,0.2675,0.2675,0.4625,19369,9345,10020,4,61,360,392,7006,54,919,10577,2344,13,11123,17025,19356,8246
920,2019,Kent,0.33166666666666667,0.31333333333333335,0.34833333333333333,27341,13175,14166,0,85,5553,3459,6251,721,2657,8614,5814,2253,14932,21527,25088,12409
921,2019,Kettle Falls,0.15,0.26,0.6,1135,575,558,2,29,13,9,88,1,88,907,12,59,590,1123,1076,545
922,2019,Kittitas,0.17,0.41,0.41,675,333,342,0,0,5,5,151,0,6,508,65,21,345,610,654,330
923,2019,La Center,0.255,0.22,0.525,1718,839,874,5,8,12,9,117,4,56,1512,34,97,416,1684,1621,1302
924,2019,La Conner,0.22,0.5,0.28,665,325,340,0,216,4,1,81,0,60,303,173,36,394,492,629,271
925,2019,Lake Chelan,0.365,0.25,0.385,1446,654,791,1,0,11,4,804,1,12,614,384,39,927,1062,1407,519
926,2019,Lake Stevens,0.3,0.27,0.43,9654,4613,5041,0,37,391,217,1461,38,887,6623,471,779,2706,9183,8875,6948
927,2019,Lake Washington,0.15333333333333335,0.6816666666666666,0.16,32122,15319,16795,8,47,10198,657,3441,31,2701,15047,3295,3052,3513,28827,29070,28609
928,2019,Lake Washington Institute of Technology,0.27,0.24,0.48,806,341,418,47,4,61,42,136,4,35,523,0,0,0,806,806,806
929,2019,Lakewood,0.23,0.22,0.55,2614,1228,1386,0,20,48,50,492,33,341,1630,175,110,1094,2439,2504,1520
930,2019,Longview,0.25666666666666665,0.25,0.49,6705,3333,3372,0,102,128,75,1447,58,462,4433,473,390,4384,6232,6315,2321
931,2019,Lynden,0.255,0.33999999999999997,0.41500000000000004,3590,1735,1854,1,19,121,49,873,5,165,2358,393,76,1292,3197,3514,2298
932,2019,Mabton,0.23,0.17,0.6,869,419,447,3,2,0,0,845,0,0,22,410,0,821,459,869,48
933,2019,Manson,0.3,0.34,0.36,663,325,338,0,8,0,2,432,0,2,219,31,14,481,632,649,182
934,2019,Marysville,0.27666666666666667,0.16333333333333333,0.5533333333333333,10954,5316,5628,10,633,672,212,2681,111,1187,5458,1414,458,5799,9540,10496,5155
935,2019,Mead,0.23249999999999998,0.4675,0.2975,10857,5307,5550,0,74,153,127,775,117,909,8702,380,1032,3460,10477,9825,7397
936,2019,Medical Lake,0.185,0.35,0.47,2002,919,1083,0,8,20,54,228,8,152,1532,13,35,794,1989,1967,1208
937,2019,Mercer Island,0.1,0.76,0.14,4491,2089,2396,6,2,1018,36,219,7,522,2687,172,694,174,4319,3797,4317
938,2019,Meridian,0.43,0.24,0.33,1807,867,940,0,24,109,16,375,2,110,1171,220,75,732,1587,1732,1075
939,2019,Methow Valley,0.11499999999999999,0.52,0.365,730,353,377,0,5,2,2,55,0,36,629,21,114,312,709,616,418
940,2019,Monroe,0.255,0.33999999999999997,0.4,6778,3342,3433,3,31,138,90,1542,10,415,4552,650,65,2060,6128,6713,4718
941,2019,Montesano,0.38,0.25,0.37,1467,701,766,0,24,15,10,164,1,119,1134,31,107,560,1436,1360,907
942,2019,Moses Lake,0.29,0.26,0.44,8983,4431,4552,0,27,82,90,4437,9,236,4102,1406,483,5987,7577,8500,2996
943,2019,Mount Adams,0.18,0.29,0.53,904,442,462,0,472,0,3,337,1,54,37,484,30,872,420,874,32
944,2019,Mount Vernon,0.32,0.29,0.39,7156,3501,3655,0,37,140,68,3892,60,150,2809,1664,309,4539,5492,6847,2617
945,2019,Mukilteo,0.32,0.34,0.34,16074,7711,8361,2,64,2326,1278,4613,164,1654,5975,3310,930,8468,12764,15144,7606
946,2019,Napavine,0.34,0.17,0.49,849,393,456,0,1,5,4,125,1,52,661,19,47,404,830,802,445
947,2019,Newport,0.07500000000000001,0.275,0.645,1140,514,626,0,11,4,4,68,1,69,983,0,125,755,1140,1015,385
948,2019,Nine Mile Falls,0.24,0.48,0.28,1440,664,776,0,14,7,10,88,3,79,1239,4,55,408,1436,1385,1032
949,2019,Nooksack Valley,0.36,0.26,0.38,1982,928,1054,0,66,18,11,673,3,102,1109,266,14,1144,1716,1968,838
950,2019,North Franklin,0.28500000000000003,0.20500000000000002,0.51,2167,1045,1120,2,3,24,8,1561,1,21,549,789,62,1644,1378,2105,523
951,2019,North Kitsap,0.24666666666666667,0.3466666666666667,0.4066666666666667,6088,3031,3056,1,299,180,61,907,41,707,3893,260,623,2111,5828,5465,3977
952,2019,North Mason,0.305,0.15000000000000002,0.5449999999999999,2338,1106,1231,1,24,16,9,601,11,168,1509,350,67,1359,1988,2271,979
953,2019,Northshore,0.19,0.5875,0.2225,23982,11599,12316,67,52,5145,512,3031,38,2118,13086,1958,4373,3595,22024,19609,20387
954,2019,Oak Harbor,0.215,0.31,0.48,6091,2940,3146,5,29,351,263,1089,42,746,3571,268,422,2520,5823,5669,3571
955,2019,Ocean Beach,0.15,0.43,0.43,1103,524,579,0,13,10,1,190,1,67,819,50,49,798,1053,1054,305
956,2019,Ocosta,0.4,0.34,0.26,634,292,342,0,19,2,2,153,1,65,392,54,11,556,580,623,78
957,2019,Okanogan,0.235,0.255,0.51,1163,542,615,6,94,3,9,320,0,92,645,100,40,754,1063,1123,409
958,2019,Olympia,0.25,0.49,0.26666666666666666,10302,4913,5374,15,60,766,295,1294,41,1151,6695,324,358,3395,9978,9944,6907
959,2019,Omak,0.195,0.315,0.49,5617,2879,2735,3,403,213,301,921,48,353,3378,281,53,3944,5336,5564,1673
960,2019,Onalaska,0.38,0.09,0.53,858,419,439,0,4,3,0,88,1,51,711,30,35,508,828,823,350
961,2019,Oroville,0.16,0.38,0.47,580,283,297,0,9,4,1,231,0,13,322,68,7,425,512,573,155
962,2019,Orting,0.22,0.23,0.55,2564,1223,1338,3,14,39,39,379,12,233,1847,87,78,896,2477,2486,1668
963,2019,Othello,0.27,0.24,0.49,4809,2295,2514,0,3,14,6,4325,1,27,433,1874,208,3999,2935,4601,810
964,2019,Pasco,0.29000000000000004,0.175,0.535,19217,9428,9788,1,32,240,190,13605,50,491,4609,6541,1293,14085,12676,17924,5132
965,2019,Peninsula,0.195,0.4025,0.405,9615,4723,4892,0,29,168,76,925,18,1040,7359,175,789,2135,9440,8826,7480
966,2019,Port Angeles,0.335,0.25,0.42,3688,1756,1928,4,182,63,24,358,8,393,2660,56,452,2016,3632,3236,1672
967,2019,Port Townsend,0.23,0.32,0.45,1235,611,621,3,15,21,13,105,1,88,992,33,87,627,1202,1148,608
968,2019,Prosser,0.27,0.27,0.46,2654,1316,1338,0,17,29,8,1692,4,76,815,613,67,1915,2041,2587,739
969,2019,Pullman,0.16,0.56,0.28,2815,1342,1467,6,15,248,81,336,11,197,1927,161,135,934,2654,2680,1881
970,2019,Puyallup,0.2375,0.36,0.40249999999999997,23557,11368,12187,2,240,1376,1167,4088,443,2982,13261,1376,1413,9135,22181,22144,14422
971,2019,Quillayute Valley,0.36,0.18,0.46,3348,1835,1512,1,77,59,109,828,15,332,1928,233,37,1892,3115,3311,1456
972,2019,Quincy,0.325,0.225,0.45,3014,1539,1475,0,2,8,10,2646,0,12,336,1289,125,2512,1725,2889,502
973,2019,Rainier,0.13,0.11,0.76,930,458,471,1,5,4,4,98,3,85,731,3,27,433,927,903,497
974,2019,Raymond,0.31,0.17,0.51,596,287,305,4,12,26,2,171,2,15,368,68,24,404,528,572,192
975,2019,Reardan-Edwall,0.17,0.3,0.53,688,342,345,1,27,2,0,26,1,35,597,12,5,304,676,683,384
976,2019,Renton,0.3025,0.35,0.34750000000000003,16158,7841,8303,14,69,4003,2322,4094,181,1535,3954,2910,1226,8356,13248,14932,7802
977,2019,Richland,0.19,0.13,0.68,14288,6969,7318,1,62,490,213,2781,18,682,10042,754,981,5582,13534,13307,8706
978,2019,Ridgefield,0.27,0.37,0.35,3497,1725,1772,0,11,59,20,443,6,222,2736,114,257,855,3383,3240,2642
979,2019,Ritzville,0.28,0.28,0.44,377,175,202,0,6,7,1,40,1,11,311,0,0,180,377,377,197
980,2019,Riverside,0.175,0.28,0.55,1541,717,821,3,24,11,8,95,1,55,1347,8,48,781,1533,1493,760
981,2019,Riverview,0.125,0.625,0.245,3377,1661,1711,5,11,109,28,442,4,167,2616,175,27,456,3202,3350,2921
982,2019,Rochester,0.255,0.13,0.615,2247,1049,1196,2,72,15,5,507,9,188,1451,207,154,1199,2040,2093,1048
983,2019,Royal,0.35,0.12,0.53,1766,887,879,0,1,2,0,1445,0,4,314,792,115,1012,974,1651,754
984,2019,San Juan Island,0.24,0.52,0.245,782,406,374,2,6,11,4,149,0,35,577,53,3,313,729,779,469
985,2019,Sedro-Woolley,0.255,0.175,0.5700000000000001,4668,2282,2384,2,99,27,20,1010,17,209,3286,394,142,2568,4274,4526,2100
986,2019,Selah,0.225,0.305,0.47,3912,1919,1989,4,14,18,16,1244,3,127,2490,344,284,2105,3568,3628,1807
987,2019,Sequim,0.23,0.38,0.395,2773,1330,1443,0,44,45,16,352,7,215,2094,57,252,1336,2716,2521,1437
988,2019,Shelton,0.165,0.16,0.6799999999999999,4705,2254,2442,9,150,23,29,1597,11,365,2530,863,96,3282,3842,4609,1423
989,2019,Shoreline,0.27666666666666667,0.5433333333333333,0.18333333333333335,9985,4781,5204,0,30,1284,791,1401,54,1239,5186,852,1014,2817,9133,8971,7168
990,2019,Snohomish,0.2733333333333334,0.42333333333333334,0.2966666666666667,9840,4756,5072,12,50,477,107,1170,16,673,7347,417,2006,2021,9423,7834,7819
991,2019,Snoqualmie Valley,0.19,0.55,0.26,7335,3498,3834,3,39,519,71,606,19,485,5596,233,379,784,7102,6956,6551
992,2019,South Bend,0.3,0.35,0.35,650,330,319,1,17,18,4,286,1,66,258,93,1,451,557,649,199
993,2019,South Kitsap,0.22,0.29000000000000004,0.495,9908,4756,5151,1,102,254,165,1270,151,1204,6762,289,821,3844,9619,9087,6064
994,2019,South Whidbey,0.235,0.45499999999999996,0.31,1343,686,655,2,8,24,12,100,4,99,1096,10,54,413,1333,1289,930
995,2019,Spokane,0.2357142857142857,0.3242857142857143,0.4414285714285714,31204,15094,16098,12,314,719,1020,3516,617,4079,20933,2154,1022,18594,29050,30182,12610
996,2019,Stanwood-Camano,0.295,0.22499999999999998,0.48,4809,2301,2508,0,39,59,42,515,17,310,3827,135,162,1528,4674,4647,3281
997,2019,Stevenson-Carson,0.17,0.32,0.51,946,473,473,0,25,5,2,132,1,57,724,33,57,521,913,889,425
998,2019,Sumner,0.22666666666666666,0.3866666666666667,0.38666666666666666,10336,5041,5295,0,61,214,123,1515,46,1085,7292,383,576,3258,9953,9760,7078
999,2019,Sunnyside,0.24,0.24,0.52,6803,3337,3466,0,3,5,13,6284,0,52,446,2049,120,164,4754,6683,6639
1000,2019,Tacoma,0.215,0.34,0.445,30389,14818,15549,22,301,2674,3950,6515,958,4727,11264,3238,1201,18276,27151,29188,12113
1001,2019,Tahoma,0.25,0.45,0.3,9180,4369,4806,5,28,543,190,995,64,994,6366,322,447,1410,8858,8733,7770
1002,2019,Tenino,0.38,0.15,0.47,1336,617,719,0,14,9,6,114,2,69,1122,14,6,679,1322,1330,657
1003,2019,Toledo,0.41500000000000004,0.1,0.485,861,399,459,3,17,5,9,80,1,31,718,14,16,477,847,845,384
1004,2019,Tonasket,0.11,0.3,0.59,1153,569,584,0,12,3,3,440,2,62,631,142,12,870,1011,1141,283
1005,2019,Toppenish,0.255,0.315,0.43000000000000005,4738,2296,2442,0,467,36,27,3505,2,45,656,1603,261,4066,3135,4477,672
1006,2019,Tukwila,0.34,0.34,0.33,3009,1474,1506,29,26,792,646,894,118,188,345,1030,84,2310,1979,2925,699
1007,2019,Tumwater,0.3233333333333333,0.27,0.4066666666666667,6760,3256,3499,5,35,175,126,908,33,661,4822,143,291,2280,6617,6469,4480
1008,2019,University Place,0.29,0.43,0.28,5768,2816,2952,0,25,536,536,918,77,973,2703,354,203,2218,5414,5565,3550
1009,2019,Vancouver,0.24285714285714288,0.37142857142857144,0.38571428571428573,23298,11373,11925,0,103,751,651,6358,525,1969,12941,3237,663,12092,20061,22635,11206
1010,2019,Vashon Island,0.215,0.575,0.215,1525,716,809,0,2,28,5,202,1,130,1157,81,59,384,1444,1466,1141
1011,2019,Wahluke,0.35,0.125,0.515,2479,1184,1295,0,11,0,2,2402,1,4,59,1344,0,2306,1135,2479,173
1012,2019,Wapato,0.235,0.225,0.54,3416,1615,1799,2,679,65,0,2499,2,94,77,1697,131,3019,1719,3285,397
1013,2019,Warden,0.47,0.13,0.4,959,484,475,0,0,1,4,748,0,17,189,262,32,853,697,927,106
1014,2019,Washougal,0.27,0.2,0.53,3234,1554,1680,0,12,36,24,353,2,197,2610,90,87,1271,3144,3147,1963
1015,2019,Wenatchee,0.365,0.26,0.375,7930,3755,4174,1,17,88,30,4055,4,183,3553,1825,828,4512,6105,7102,3418
1016,2019,West Valley (Spokane),0.27,0.37,0.36,3730,1617,1847,266,28,48,64,388,16,334,2852,128,138,2143,3602,3592,1587
1017,2019,West Valley (Yakima),0.29,0.36,0.35,5569,2740,2825,4,55,143,42,1847,9,174,3279,429,443,2503,5140,5126,3066
1018,2019,White River,0.25,0.23,0.52,4161,2047,2114,0,31,52,25,463,6,247,3337,156,282,1314,4005,3879,2847
1019,2019,White Salmon Valley,0.12,0.375,0.51,1285,591,693,1,10,4,2,406,2,42,819,196,100,589,1089,1185,696
1020,2019,Woodland,0.245,0.13,0.625,2535,1193,1342,0,8,19,15,571,2,99,1821,213,170,1228,2322,2365,1307
1021,2019,Yakima,0.28,0.26666666666666666,0.45333333333333337,16419,8126,8293,0,150,64,91,13058,18,396,2642,4947,462,13681,11472,15957,2738
1022,2019,Yelm,0.185,0.28500000000000003,0.53,5902,2813,3085,4,108,85,73,937,89,686,3924,165,357,3001,5737,5545,2901
1023,2019,Zillah,0.31,0.22,0.47,1335,620,715,0,52,4,1,723,0,53,502,144,46,789,1191,1289,546
